expenditure ID,TIF DISTRICT,AREA,DISTRICT EXPIRATION,PROJECT / EXPENDITURE,YEAR,STATUS,AMOUNT,BALANCE,REF
1,105th/Vincennes,South Side,2025-12-31,FY Beginning Cash Balance ,2009,Appropriated,621878,621878,T-111
2,105th/Vincennes,South Side,2025-12-31,Estimated Incremental Property Tax Revenue ,2010,Committed,211987,833864,T-111
3,105th/Vincennes,South Side,2025-12-31,Administrative Costs ,2010,Committed,-2752,831112,T-111
4,105th/Vincennes,South Side,2025-12-31,Estimated Incremental Property Tax Revenue ,2011,Committed,211987,1043099,T-111
5,105th/Vincennes,South Side,2025-12-31,Administrative Costs ,2011,Committed,-2752,1040347,T-111
6,111th/Kedzie,South Side,2022-09-29,FY Beginning Cash Balance ,2009,Appropriated,1637868,1637868,T- 73
7,111th/Kedzie,South Side,2022-09-29,Terraco RDA initial reimbursement ,2009,Committed,-585000,1052868,T- 73
8,111th/Kedzie,South Side,2022-09-29,Estimated Incremental Property Tax Revenue ,2010,Committed,550000,1602868,T- 73
9,111th/Kedzie,South Side,2022-09-29,Administrative Costs ,2010,Committed,-9000,1593868,T- 73
10,111th/Kedzie,South Side,2022-09-29,Terraco RDA note payment ,2010,Committed,-110000,1483868,T- 73
11,111th/Kedzie,South Side,2022-09-29,Acquisition 4000 W. 111th Street ,2010,Committed,-600000,883868,T- 73
12,111th/Kedzie,South Side,2022-09-29,Estimated Incremental Property Tax Revenue ,2011,Committed,550000,1433868,T- 73
13,111th/Kedzie,South Side,2022-09-29,Administrative Costs ,2011,Committed,-9000,1424868,T- 73
14,111th/Kedzie,South Side,2022-09-29,Terraco RDA note payment ,2011,Committed,-110000,1314868,T- 73
15,111th/Kedzie,South Side,2022-09-29,111th Street / Kedzie Streetscape Master Plan ,2011,Committed,-180000,1134868,T- 73
16,119th/Halsted,South Side,2026-12-31,FY Beginning Cash Balance ,2009,Appropriated,1358411,1358411,T-114
17,119th/Halsted,South Side,2026-12-31,Pre-acquisition Services Account Increase ,2009,Appropriated,-50000,1308411,T-114
18,119th/Halsted,South Side,2026-12-31,Neighborhood Improvement Fund ,2009,Committed,0,1308411,T-114
19,119th/Halsted,South Side,2026-12-31,"Streetlight modifications: 119th, Wentworth to Halsted to Peroria to Morgan ",2009,Committed,-135000,1173411,T-114
20,119th/Halsted,South Side,2026-12-31,"SBIF  (750K auth., 250k remaining) ",2009,Committed,-250000,923411,T-114
21,119th/Halsted,South Side,2026-12-31,Estimated Incremental Property Tax Revenue ,2010,Committed,591676,1515087,T-114
22,119th/Halsted,South Side,2026-12-31,Administrative Costs ,2010,Committed,-11200,1503887,T-114
23,119th/Halsted,South Side,2026-12-31,Preferred Halsted RDA note payment ,2010,Committed,-73000,1430887,T-114
24,119th/Halsted,South Side,2026-12-31,Neigh. Imp. Prgm. Note Debt Service 2010 ,2010,Committed,-148858,1282029,T-114
25,119th/Halsted,South Side,2026-12-31,"SBIF  (750k auth., 0k remaining) ",2010,Committed,-250000,1032029,T-114
26,119th/Halsted,South Side,2026-12-31,Estimated Incremental Property Tax Revenue ,2011,Committed,591676,1623705,T-114
27,119th/Halsted,South Side,2026-12-31,Administrative Costs ,2011,Committed,-11200,1612505,T-114
28,119th/Halsted,South Side,2026-12-31,Preferred Halsted RDA note payment ,2011,Committed,-73000,1539505,T-114
29,119th/Halsted,South Side,2026-12-31,Neigh. Imp. Prgm. Note Debt Service 2011 ,2011,Committed,-191608,1347897,T-114
30,119th/Halsted,South Side,2026-12-31,FY Beginning Cash Balance ,2009,Appropriated,1821762,1821762,T-114
31,119th/Halsted,South Side,2026-12-31,Professional Services Account Increase ,2009,Appropriated,-25000,1796762,T-114
32,119th/Halsted,South Side,2026-12-31,JTA RDA payment ,2009,Appropriated,-96213,1700549,T-114
33,119th/Halsted,South Side,2026-12-31,"SBIF (1M auth., 750k remaining) ",2009,Appropriated,-300000,1400549,T-114
34,119th/Halsted,South Side,2026-12-31,Marshfield Plaza remediation payment ,2009,Appropriated,-1000000,400549,T-114
35,119th/Halsted,South Side,2026-12-31,"Streetlight modifications: 119th, Ada to Ashland to Loomis ",2009,Committed,-24300,376249,T-114
36,119th/Halsted,South Side,2026-12-31,"Sidewalk, curb & gutter: Vincennes, 107th to 108th, west side only ",2009,Requested,-100000,276249,T-114
37,119th/Halsted,South Side,2026-12-31,Port from Western/Rock Island for Blackwelder Park ,2010,Committed,1250000,1526249,T-114
38,119th/Halsted,South Side,2026-12-31,Estimated Incremental Property Tax Revenue ,2010,Committed,736580,2262829,T-114
39,119th/Halsted,South Side,2026-12-31,Administrative Costs ,2010,Committed,-14000,2248829,T-114
40,119th/Halsted,South Side,2026-12-31,Neigh. Imp. Prgm. LISC Note Debt Service 2010  -- 1 of 5 remaining ,2010,Committed,-158000,2090829,T-114
41,119th/Halsted,South Side,2026-12-31,Marshfield Plaza Taxable Note  -- B Payment ,2010,Committed,-175000,1915829,T-114
42,119th/Halsted,South Side,2026-12-31,"SBIF (1M auth., 350k remaining) ",2010,Committed,-350000,1565829,T-114
43,119th/Halsted,South Side,2026-12-31,Blackwelder Park improvements ,2010,Committed,-1250000,315829,T-114
44,119th/Halsted,South Side,2026-12-31,Marshfield Plaza Tax-Exempt Note  -- A Payment ,2010,Committed,-1600000,-1284171,T-114
45,119th/Halsted,South Side,2026-12-31,Speed Humps ,2010,Pending,-27500,-1311671,T-114
46,119th/Halsted,South Side,2026-12-31,"Sidewalk Replacement, Lafflin 119th-120th ",2010,Pending,-42236,-1353907,T-114
47,119th/Halsted,South Side,2026-12-31,Estimated Incremental Property Tax Revenue ,2011,Committed,736580,-617327,T-114
48,119th/Halsted,South Side,2026-12-31,Administrative Costs ,2011,Committed,-14000,-631327,T-114
49,119th/Halsted,South Side,2026-12-31,Neigh. Imp. Prgm. LISC Note Debt Service 2011  -- 1 of 4 remaining ,2011,Committed,-200750,-832077,T-114
50,119th/Halsted,South Side,2026-12-31,"SBIF (1M auth., 0k remaining) ",2010,Committed,-350000,-1182077,T-114
51,119th/Halsted,South Side,2026-12-31,Marshfield Plaza Taxable Note  -- B Payment ,2011,Committed,-450000,-1632077,T-114
52,119th/Halsted,South Side,2026-12-31,Marshfield Plaza Tax-Exempt Note  -- A Payment ,2011,Committed,-1750000,-3382077,T-114
53,126th/Torrence,South Side,2017-12-21,FY Beginning Cash Balance ,2009,Appropriated,971207,971207,T- 10
54,126th/Torrence,South Side,2017-12-21,Chicago Manufacturing Campus/ Ford Supplier Park Note Payment #3 ,2009,Appropriated,-169973,801234,T- 10
55,126th/Torrence,South Side,2017-12-21,Chicago Manufacturing Campus/ Ford Supplier Park Note Payment #1 ,2009,Appropriated,-374101,427133,T- 10
56,126th/Torrence,South Side,2017-12-21,Chicago Manufacturing Campus/ Ford Supplier Park Note Payment #2 ,2009,Appropriated,-402852,24280,T- 10
57,126th/Torrence,South Side,2017-12-21,Estimated Incremental Property Tax Revenue ,2010,Committed,911778,936058,T- 10
58,126th/Torrence,South Side,2017-12-21,Chicago Manufacturing Campus Payment [3 notes; amout TBD] ,2010,Committed,0,936058,T- 10
59,126th/Torrence,South Side,2017-12-21,Administrative Costs ,2010,Committed,-5341,930717,T- 10
60,126th/Torrence,South Side,2017-12-21,Estimated Incremental Property Tax Revenue ,2011,Committed,911778,1842495,T- 10
61,126th/Torrence,South Side,2017-12-21,Chicago Manufacturing Campus Payment [3 notes; amout TBD] ,2011,Committed,0,1842495,T- 10
62,126th/Torrence,South Side,2017-12-21,Administrative Costs ,2011,Committed,-5341,1837154,T- 10
63,134th & Avenue K,South Side,2032-12-31,FY Beginning Cash Balance ,2009,Appropriated,0,0,T-159
64,134th & Avenue K,South Side,2032-12-31,Adminstration ,2009,Committed,0,0,T-159
65,134th & Avenue K,South Side,2032-12-31,Estimated Incremental Property Tax Revenue ,2010,Committed,0,0,T-159
66,134th & Avenue K,South Side,2032-12-31,Estimated Incremental Property Tax Revenue ,2011,Committed,0,0,T-159
67,134th & Avenue K,South Side,2032-12-31,FY Beginning Cash Balance ,2009,Appropriated,1710913,1710913,T-159
68,134th & Avenue K,South Side,2032-12-31,"Stamped Concrete: Archer, Wentworth to Princeton ",2009,Appropriated,-16434,1694479,T-159
69,134th & Avenue K,South Side,2032-12-31,Teachers Academy Debt Service 2010 -24th/Michigan share ,2009,Appropriated,-190000,1504479,T-159
70,134th & Avenue K,South Side,2032-12-31,Teachers Academy Debt Service 2009 -24th/Michigan share ,2009,Appropriated,-190000,1314479,T-159
71,134th & Avenue K,South Side,2032-12-31,"Arterial streets ADA ramps design & construction  (min = 18,600 for design) ",2009,Appropriated,-254000,1060479,T-159
72,134th & Avenue K,South Side,2032-12-31,Michigan Avenue Streetscaping  -- Design ,2009,Committed,-200000,860479,T-159
73,134th & Avenue K,South Side,2032-12-31,Port from Chinatown Basin for Red Line Chinatown station ,2009,Pending,600000,1460479,T-159
74,134th & Avenue K,South Side,2032-12-31,Motor Row Zoning Plan ,2009,Pending,-65000,1395479,T-159
75,134th & Avenue K,South Side,2032-12-31,Broadband Initiative ,2009,Pending,-161712,1233767,T-159
76,134th & Avenue K,South Side,2032-12-31,SBIF (250k of 500k auth.) ,2009,Pending,-250000,983767,T-159
77,134th & Avenue K,South Side,2032-12-31,Red Line Chinatown station improvements ,2009,Pending,-600000,383767,T-159
78,134th & Avenue K,South Side,2032-12-31,Estimated Incremental Property Tax Revenue ,2010,Committed,494540,878307,T-159
79,134th & Avenue K,South Side,2032-12-31,Administrative Costs ,2010,Committed,-8214,870093,T-159
80,134th & Avenue K,South Side,2032-12-31,Michigan Avenue Streetscaping  -- Construction ,2010,Committed,-300000,570093,T-159
81,134th & Avenue K,South Side,2032-12-31,Port from Chinatown Basin for Wentworth Ave. Connector  -- design ,2010,Pending,500000,1070093,T-159
82,134th & Avenue K,South Side,2032-12-31,Wentworth Ave. Connector  -- design ,2010,Pending,-500000,570093,T-159
83,134th & Avenue K,South Side,2032-12-31,Estimated Incremental Property Tax Revenue ,2011,Committed,494540,1064634,T-159
84,134th & Avenue K,South Side,2032-12-31,Administrative Costs ,2011,Committed,-8214,1056420,T-159
85,134th & Avenue K,South Side,2032-12-31,Teachers Academy Debt Service 2011 -24th/Michigan share ,2011,Committed,-190000,866420,T-159
86,26th/King,South Side,2030-12-31,FY Beginning Cash Balance ,2009,Appropriated,25000,25000,T-141
87,26th/King,South Side,2030-12-31,Administrative Costs ,2009,Committed,0,25000,T-141
88,26th/King,South Side,2030-12-31,Estimated Incremental Property Tax Revenue ,2010,Committed,1586000,1611000,T-141
89,26th/King,South Side,2030-12-31,Administrative Costs ,2010,Committed,0,1611000,T-141
90,26th/King,South Side,2030-12-31,Estimated Incremental Property Tax Revenue ,2011,Committed,1586000,3197000,T-141
91,26th/King,South Side,2030-12-31,Administrative Costs ,2011,Committed,0,3197000,T-141
92,26th/King,South Side,2030-12-31,FY Beginning Cash Balance ,2009,Appropriated,10604838,10604838,T-141
93,26th/King,South Side,2030-12-31,Miracle L.L.C. Note Payment ,2009,Appropriated,-250000,10354838,T-141
94,26th/King,South Side,2030-12-31,11th Ward Yard renovations ,2009,Appropriated,-2500000,7854838,T-141
95,26th/King,South Side,2030-12-31,"Streetscape: Halsted, 36th - 39th ",2009,Appropriated,-3700000,4154838,T-141
96,26th/King,South Side,2030-12-31,Morgan Streetscape Study ,2009,Committed,-50000,4104838,T-141
97,26th/King,South Side,2030-12-31,Halsted Street Lighting ,2009,Committed,-66500,4038338,T-141
98,26th/King,South Side,2030-12-31,Morgan Street Lighting ,2009,Committed,-66500,3971838,T-141
99,26th/King,South Side,2030-12-31,Pre-Acquisition Disposition Services ,2009,Committed,-100000,3871838,T-141
100,26th/King,South Side,2030-12-31,Wendt Furniture 3410 S. Halsted demo ,2009,Committed,-250000,3621838,T-141
101,26th/King,South Side,2030-12-31,SBIF ,2009,Committed,-500000,3121838,T-141
102,26th/King,South Side,2030-12-31,DSS/CDOT ward yard  -- 3812 S. Iron ,2009,Committed,-2500000,621838,T-141
103,26th/King,South Side,2030-12-31,Broadband Initiative ,2009,Pending,-227515,394323,T-141
104,26th/King,South Side,2030-12-31,Property Management Ramova/Clocktown ,2009,Pending,-300000,94323,T-141
105,26th/King,South Side,2030-12-31,Landscaping & Fencing - 3100-04 S. Halsted ,2009,Pending,-500000,-405677,T-141
106,26th/King,South Side,2030-12-31,Estimated Incremental Property Tax Revenue ,2010,Committed,3297415,2891738,T-141
107,26th/King,South Side,2030-12-31,Administrative Costs ,2010,Committed,-61000,2830738,T-141
108,26th/King,South Side,2030-12-31,Miracle LLC Note Payment ,2010,Committed,-250000,2580738,T-141
109,26th/King,South Side,2030-12-31,Acre Condos Payment ,2010,Committed,-250000,2330738,T-141
110,26th/King,South Side,2030-12-31,Acquisition - 3558-62 S. Halsted for Ramova Theater Redevelopment ,2010,Pending,-800000,1530738,T-141
111,26th/King,South Side,2030-12-31,Estimated Incremental Property Tax Revenue ,2011,Committed,3297415,4828153,T-141
112,26th/King,South Side,2030-12-31,Administrative Costs ,2011,Committed,-61000,4767153,T-141
113,26th/King,South Side,2030-12-31,Miracle LLC Note Payment ,2011,Committed,-250000,4517153,T-141
114,26th/King,South Side,2030-12-31,Acre Condos Payment ,2011,Committed,-250000,4267153,T-141
115,26th/King,South Side,2030-12-31,TIF Works ,2011,Pending,-200000,4067153,T-141
116,26th/King,South Side,2030-12-31,SBIF ,2011,Pending,-500000,3567153,T-141
117,35th/State,South Side,2028-12-31,FY Beginning Cash Balance ,2009,Appropriated,1384077,1384077,T-131
118,35th/State,South Side,2028-12-31,Lighting: Federal to west of State St ,2009,Appropriated,-41000,1343077,T-131
119,35th/State,South Side,2028-12-31,Stateway Gardens / Park Blvd.  -- CHA Note I ,2009,Appropriated,-242936,1100141,T-131
120,35th/State,South Side,2028-12-31,Pre-Acquisition ,2009,Committed,-10000,1090141,T-131
121,35th/State,South Side,2028-12-31,Estimated Incremental Property Tax Revenue ,2010,Committed,509390,1599531,T-131
122,35th/State,South Side,2028-12-31,Administrative Costs ,2010,Committed,-7100,1592431,T-131
123,35th/State,South Side,2028-12-31,Stateway Gardens / Park Blvd.  -- CHA Note I ,2010,Committed,-250000,1342431,T-131
124,35th/State,South Side,2028-12-31,Estimated Incremental Property Tax Revenue ,2011,Committed,509390,1851821,T-131
125,35th/State,South Side,2028-12-31,Administrative Costs ,2011,Committed,-7100,1844721,T-131
126,35th/State,South Side,2028-12-31,FY Beginning Cash Balance ,2009,Appropriated,1010106,1010106,T-131
127,35th/State,South Side,2028-12-31,Professional Service - Pre-Acquisition ,2009,Pending,-50000,960106,T-131
128,35th/State,South Side,2028-12-31,Broadband Initiative ,2009,Pending,-106085,854021,T-131
129,35th/State,South Side,2028-12-31,SBIF ,2009,Pending,-350000,504021,T-131
130,35th/State,South Side,2028-12-31,Estimated Incremental Property Tax Revenue ,2010,Committed,190014,694035,T-131
131,35th/State,South Side,2028-12-31,Administrative Costs ,2010,Committed,-6125,687910,T-131
132,35th/State,South Side,2028-12-31,Estimated Incremental Property Tax Revenue ,2011,Committed,190014,877924,T-131
133,35th/State,South Side,2028-12-31,Administrative Costs ,2011,Committed,-6125,871799,T-131
134,40th/State,South Side,2028-12-31,FY Beginning Cash Balance ,2009,Appropriated,0,0,T-132
135,40th/State,South Side,2028-12-31,Administrative Costs ,2010,Committed,0,0,T-132
136,40th/State,South Side,2028-12-31,Estimated Incremental Property Tax Revenue ,2010,Committed,0,0,T-132
137,40th/State,South Side,2028-12-31,Estimated Incremental Property Tax Revenue ,2011,Committed,0,0,T-132
138,40th/State,South Side,2028-12-31,Administrative Costs ,2011,Committed,0,0,T-132
139,40th/State,South Side,2028-12-31,FY Beginning Cash Balance ,2009,Appropriated,487148,487148,T-132
140,40th/State,South Side,2028-12-31,Paul G. Stewart Apts. Assoc. Annual Payment ,2009,Appropriated,-68540,418608,T-132
141,40th/State,South Side,2028-12-31,Estimated Incremental Property Tax Revenue ,2010,Committed,143273,561881,T-132
142,40th/State,South Side,2028-12-31,Administrative Costs ,2010,Committed,-3500,558381,T-132
143,40th/State,South Side,2028-12-31,Paul G. Stewart Apts. Assoc. Annual Payment ,2010,Committed,-75619,482762,T-132
144,40th/State,South Side,2028-12-31,Estimated Incremental Property Tax Revenue ,2011,Committed,143273,626036,T-132
145,40th/State,South Side,2028-12-31,Administrative Costs ,2011,Committed,-3500,622536,T-132
146,40th/State,South Side,2028-12-31,Paul G. Stewart Apts. Assoc. Annual Payment ,2011,Committed,-75619,546917,T-132
147,40th/State,South Side,2028-12-31,FY Beginning Cash Balance ,2009,Appropriated,5262893,5262893,T-132
148,40th/State,South Side,2028-12-31,Demolition account increase ,2009,Appropriated,-4500,5258393,T-132
149,40th/State,South Side,2028-12-31,Job Training program  -- MOWD ,2009,Appropriated,-7000,5251393,T-132
150,40th/State,South Side,2028-12-31,Pre-acquisition Account Increase ,2009,Appropriated,-75000,5176393,T-132
151,40th/State,South Side,2028-12-31,Hearts United Phase III LP RDA - Annual Payment ,2009,Appropriated,-77626,5098767,T-132
152,40th/State,South Side,2028-12-31,Hearts United Phase II LP RDA - Annual Payment ,2009,Appropriated,-340132,4758635,T-132
153,40th/State,South Side,2028-12-31,Hearts United I LP RDA Annual Payment ,2009,Appropriated,-382421,4376215,T-132
154,40th/State,South Side,2028-12-31,Port to Madden/Wells for acquisition ,2009,Committed,-327000,4049215,T-132
155,40th/State,South Side,2028-12-31,Port to Madden/Wells for acquisition ,2009,Committed,-700000,3349215,T-132
156,40th/State,South Side,2028-12-31,Broadband Initiative ,2009,Pending,-772618,2576597,T-132
157,40th/State,South Side,2028-12-31,Shops & Lofts at 47th ,2009,Pending,-2384472,192125,T-132
158,40th/State,South Side,2028-12-31,Estimated Incremental Property Tax Revenue ,2010,Committed,1901871,2093996,T-132
159,40th/State,South Side,2028-12-31,Administrative Costs ,2010,Committed,-36200,2057796,T-132
160,40th/State,South Side,2028-12-31,Hearts United Phase III LP - Annual Payment ,2010,Committed,-80335,1977461,T-132
161,40th/State,South Side,2028-12-31,Hearts United Phase II LP - Annual Payment ,2010,Committed,-332545,1644916,T-132
162,40th/State,South Side,2028-12-31,Hearts United I LP RDA Annual Payment ,2010,Committed,-514999,1129917,T-132
163,40th/State,South Side,2028-12-31,Shops & Lofts at 47th ,2010,Pending,-2384472,-1254555,T-132
164,40th/State,South Side,2028-12-31,Estimated Incremental Property Tax Revenue ,2011,Committed,1901871,647316,T-132
165,40th/State,South Side,2028-12-31,Administrative Costs ,2011,Committed,-36200,611116,T-132
166,40th/State,South Side,2028-12-31,Hearts United Phase III LP - Annual Payment ,2011,Committed,-80335,530781,T-132
167,40th/State,South Side,2028-12-31,Hearts United Phase II LP - Annual Payment ,2011,Committed,-332545,198236,T-132
168,40th/State,South Side,2028-12-31,Shops & Lofts at 47th ,2011,Pending,-2384472,-2186236,T-132
169,40th/State,South Side,2028-12-31,FY Beginning Cash Balance ,2009,Appropriated,159488,159488,T-132
170,40th/State,South Side,2028-12-31,Wheatland Tube 2009 Note Payment ,2009,Appropriated,-142258,17230,T-132
171,40th/State,South Side,2028-12-31,Estimated Incremental Property Tax Revenue ,2010,Committed,142505,159735,T-132
172,40th/State,South Side,2028-12-31,Administrative Costs ,2010,Committed,-2633,157102,T-132
173,40th/State,South Side,2028-12-31,Wheatland Tube 2009 Note Payment ,2010,Committed,-14200,142902,T-132
174,40th/State,South Side,2028-12-31,Estimated Incremental Property Tax Revenue ,2011,Committed,142505,285407,T-132
175,40th/State,South Side,2028-12-31,Administrative Costs ,2011,Committed,-2633,282774,T-132
176,40th/State,South Side,2028-12-31,FY Beginning Cash Balance ,2009,Appropriated,7419170,7419170,T-132
177,40th/State,South Side,2028-12-31,Professional Services Account - TIF Consultant Fees ,2009,Appropriated,-25000,7394170,T-132
178,40th/State,South Side,2028-12-31,Bishop Plaza LLC RDA note payment ,2009,Appropriated,-48021,7346149,T-132
179,40th/State,South Side,2028-12-31,Cardinal LP aka Eagle LP RDA payment ,2009,Appropriated,-110000,7236149,T-132
180,40th/State,South Side,2028-12-31,Street resurfacing @ 1400 W. 46th St.  -- cancelled ,2009,Appropriated,-291485,6944664,T-132
181,40th/State,South Side,2028-12-31,"SBIF (500k auth., 0 remaining) ",2009,Appropriated,-500000,6444664,T-132
182,40th/State,South Side,2028-12-31,Budget Liquidation: Street resurfacing @ 1400 W. 46th St. ,2009,Committed,291485,6736149,T-132
183,40th/State,South Side,2028-12-31,"Street Reconstruction: 48th St, Racine to Morgan; construction ",2009,Committed,-1060000,5676149,T-132
184,40th/State,South Side,2028-12-31,"Street Reconstruction: 45th St, Ashland to Loomis; construction ",2009,Committed,-1060000,4616149,T-132
185,40th/State,South Side,2028-12-31,"WPA Street Reconstruction: 45th, Ashland to McDowell ",2009,Committed,-1200000,3416149,T-132
186,40th/State,South Side,2028-12-31,CPS ADA projects  -- Seward ,2009,Committed,-1500000,1916149,T-132
187,40th/State,South Side,2028-12-31,Acquisition for Back of the Yards Library ,2009,Committed,-1800000,116149,T-132
188,40th/State,South Side,2028-12-31,Estimated Incremental Property Tax Revenue ,2010,Committed,2179710,2295859,T-132
189,40th/State,South Side,2028-12-31,Administrative Costs ,2010,Committed,-41500,2254359,T-132
190,40th/State,South Side,2028-12-31,Bishop Plaza LLC RDA note payment  -- est. ,2010,Committed,-48021,2206338,T-132
191,40th/State,South Side,2028-12-31,Pre-Acquisition Disposition Services ,2010,Committed,-50000,2156338,T-132
192,40th/State,South Side,2028-12-31,Cardinal LP aka Eagle LP RDA payment ,2010,Committed,-110000,2046338,T-132
193,40th/State,South Side,2028-12-31,Estimated Incremental Property Tax Revenue ,2011,Committed,2179710,4226048,T-132
194,40th/State,South Side,2028-12-31,Administrative Costs ,2011,Committed,-41500,4184548,T-132
195,40th/State,South Side,2028-12-31,Bishop Plaza LLC RDA note payment  -- est. ,2011,Committed,-48021,4136527,T-132
196,40th/State,South Side,2028-12-31,Cardinal LP aka Eagle LP RDA payment ,2011,Committed,-110000,4026527,T-132
197,40th/State,South Side,2028-12-31,Streetscaping - Ashland  -- 4000 - 4300 ,2011,Pending,-2688000,1338527,T-132
198,40th/State,South Side,2028-12-31,FY Beginning Cash Balance ,2009,Appropriated,8271297,8271297,T-132
199,40th/State,South Side,2028-12-31,Demolition Account  -- DOB ,2009,Appropriated,-25000,8246297,T-132
200,40th/State,South Side,2028-12-31,Lighting: 4300-4500 Princeton ,2009,Appropriated,-54000,8192297,T-132
201,40th/State,South Side,2028-12-31,Viaduct repairs @ 47th & Normal ,2009,Appropriated,-55400,8136897,T-132
202,40th/State,South Side,2028-12-31,Ported funds from Stockyard Annex for Taylor Lauridsen Park ,2009,Committed,3950064,12086961,T-132
203,40th/State,South Side,2028-12-31,Lighting  -- add'l: 47th & Normal ,2009,Committed,-55400,12031561,T-132
204,40th/State,South Side,2028-12-31,Taylor Lauridsen environmental ,2009,Committed,-80000,11951561,T-132
205,40th/State,South Side,2028-12-31,SBIF ,2009,Committed,-500000,11451561,T-132
206,40th/State,South Side,2028-12-31,CPD-IGA: Fuller Park  -- payment 1 of 3 ,2009,Committed,-1000000,10451561,T-132
207,40th/State,South Side,2028-12-31,Taylor Lauridsen Park  -- replacement of state match ,2009,Committed,-1800000,8651561,T-132
208,40th/State,South Side,2028-12-31,Taylor Lauridsen Park ,2009,Committed,-3950064,4701497,T-132
209,40th/State,South Side,2028-12-31,54th/Morgan Housing ,2009,Pending,-100000,4601497,T-132
210,40th/State,South Side,2028-12-31,"Lighting - 41st-43rd St, BOE recommends 39th-43rd St.  -- Stckyrds Annex TIF also ",2009,Pending,-160000,4441497,T-132
211,40th/State,South Side,2028-12-31,Neighborhood Improvement Fund ,2009,Pending,-1000000,3441497,T-132
212,40th/State,South Side,2028-12-31,Estimated Incremental Property Tax Revenue ,2010,Committed,2245614,5687111,T-132
213,40th/State,South Side,2028-12-31,Administrative Costs ,2010,Committed,-42700,5644411,T-132
214,40th/State,South Side,2028-12-31,CPD-IGA: Fuller Park  -- payment 2 of 3 ,2010,Committed,-1000000,4644411,T-132
215,40th/State,South Side,2028-12-31,Estimated Incremental Property Tax Revenue ,2011,Committed,2245614,6890025,T-132
216,40th/State,South Side,2028-12-31,Administrative Costs ,2011,Committed,-42700,6847325,T-132
217,40th/State,South Side,2028-12-31,CPD-IGA: Fuller Park  -- payment 2 of 3 ,2011,Committed,-1000000,5847325,T-132
218,40th/State,South Side,2028-12-31,FY Beginning Cash Balance ,2009,Appropriated,19624017,19624017,T-132
219,40th/State,South Side,2028-12-31,Port to Pershing/King for Paul G. Stewart ,2009,Appropriated,-1500000,18124017,T-132
220,40th/State,South Side,2028-12-31,Clean Slate ,2009,Committed,-80000,18044017,T-132
221,40th/State,South Side,2028-12-31,Pre-Acquisition Account  -- R.E. ,2009,Committed,-150000,17894017,T-132
222,40th/State,South Side,2028-12-31,CPS ADA projects  -- Mollison ,2009,Committed,-750000,17144017,T-132
223,40th/State,South Side,2028-12-31,Acquisition of Harold Washington Cultrual Center ,2009,Committed,-2300000,14844017,T-132
224,40th/State,South Side,2028-12-31,Cuisine of the Diaspora RDA ,2009,Committed,-4000000,10844017,T-132
225,40th/State,South Side,2028-12-31,Small Business Improvement Fund ,2009,Pending,-500000,10344017,T-132
226,40th/State,South Side,2028-12-31,Port to Pershing/King for NIF ,2009,Pending,-500000,9844017,T-132
227,40th/State,South Side,2028-12-31,Broadband Initiative ,2009,Pending,-834250,9009767,T-132
228,40th/State,South Side,2028-12-31,Neighborhood Improvement Fund ,2009,Pending,-1000000,8009767,T-132
229,40th/State,South Side,2028-12-31,Estimated Incremental Property Tax Revenue ,2010,Committed,5060700,13070467,T-132
230,40th/State,South Side,2028-12-31,Administrative Costs ,2010,Committed,-96300,12974167,T-132
231,40th/State,South Side,2028-12-31,Port to Pershing/King for Paul G. Stewart ,2010,Committed,-352200,12621967,T-132
232,40th/State,South Side,2028-12-31,Cuisine of the Diaspora RDA ,2010,Committed,-1000000,11621967,T-132
233,40th/State,South Side,2028-12-31,Estimated Incremental Property Tax Revenue ,2011,Committed,5060700,16682666,T-132
234,40th/State,South Side,2028-12-31,Administrative Costs ,2011,Committed,-96300,16586366,T-132
235,40th/State,South Side,2028-12-31,Port to Pershing/King for Paul G. Stewart ,2011,Committed,-352500,16233866,T-132
236,40th/State,South Side,2028-12-31,Cuisine of the Diaspora RDA ,2011,Committed,-1000000,15233866,T-132
237,47th/State,South Side,2028-12-31,FY Beginning Cash Balance ,2009,Appropriated,3728741,3728741,T-136
238,47th/State,South Side,2028-12-31,TRC Senior Village ,2009,Appropriated,-543750,3184991,T-136
239,47th/State,South Side,2028-12-31,Pre-Acquisition ,2009,Committed,-50000,3134991,T-136
240,47th/State,South Side,2028-12-31,Clean Slate ,2009,Committed,-53400,3081591,T-136
241,47th/State,South Side,2028-12-31,"Sidwalks / ADA ramps: 5400 block of MLK, west side ",2009,Committed,-89527,2992064,T-136
242,47th/State,South Side,2028-12-31,Broadband Initiative ,2009,Pending,-783710,2208355,T-136
243,47th/State,South Side,2028-12-31,Estimated Incremental Property Tax Revenue ,2010,Committed,1022525,3230879,T-136
244,47th/State,South Side,2028-12-31,47th/State Retail ,2010,Committed,0,3230879,T-136
245,47th/State,South Side,2028-12-31,Administrative Costs ,2010,Committed,-13400,3217479,T-136
246,47th/State,South Side,2028-12-31,TRC Senior Village ,2010,Committed,-200000,3017479,T-136
247,47th/State,South Side,2028-12-31,Estimated Incremental Property Tax Revenue ,2011,Committed,1022525,4040004,T-136
248,47th/State,South Side,2028-12-31,47th/State Retail ,2011,Committed,0,4040004,T-136
249,47th/State,South Side,2028-12-31,Administrative Costs ,2011,Committed,-13400,4026604,T-136
250,47th/State,South Side,2028-12-31,FY Beginning Cash Balance ,2009,Appropriated,1152820,1152820,T-136
251,47th/State,South Side,2028-12-31,Willard Square Ltd. Note Payment ,2009,Appropriated,-85767,1067054,T-136
252,47th/State,South Side,2028-12-31,Estimated Incremental Property Tax Revenue ,2010,Committed,370393,1437447,T-136
253,47th/State,South Side,2028-12-31,Administrative Costs ,2010,Committed,-6852,1430595,T-136
254,47th/State,South Side,2028-12-31,Willard Square Ltd. Note Payment ,2010,Committed,-138000,1292595,T-136
255,47th/State,South Side,2028-12-31,Estimated Incremental Property Tax Revenue ,2011,Committed,370393,1662987,T-136
256,47th/State,South Side,2028-12-31,Administrative Costs ,2011,Committed,-6852,1656135,T-136
257,47th/State,South Side,2028-12-31,Willard Square Ltd. Note Payment ,2011,Committed,-138000,1518135,T-136
258,47th/State,South Side,2028-12-31,FY Beginning Cash Balance ,2009,Appropriated,1157866,1157866,T-136
259,47th/State,South Side,2028-12-31,Sidewalks @ 51st/Pulaski ,2009,Appropriated,-53500,1104366,T-136
260,47th/State,South Side,2028-12-31,51st & Lawndale RDA payment  -- amount TBD ,2009,Committed,0,1104366,T-136
261,47th/State,South Side,2028-12-31,Estimated Incremental Property Tax Revenue ,2010,Committed,744900,1849266,T-136
262,47th/State,South Side,2028-12-31,Administrative Costs ,2010,Committed,-11876,1837390,T-136
263,47th/State,South Side,2028-12-31,MSAC Ph.1 Debt Service 2010 - 51st/Archer share - Southwest Elem. ,2010,Committed,-280874,1556516,T-136
264,47th/State,South Side,2028-12-31,Estimated Incremental Property Tax Revenue ,2011,Committed,744900,2301416,T-136
265,47th/State,South Side,2028-12-31,Administrative Costs ,2011,Committed,-11876,2289540,T-136
266,47th/State,South Side,2028-12-31,MSAC Ph.1 Debt Service 2011 - 51st/Archer share - Southwest Elem. ,2011,Committed,-352247,1937293,T-136
267,47th/State,South Side,2028-12-31,FY Beginning Cash Balance ,2009,Appropriated,2498522,2498522,T-136
268,47th/State,South Side,2028-12-31,Pre-acquisition account  -- add'l ,2009,Appropriated,-20000,2478522,T-136
269,47th/State,South Side,2028-12-31,Job Training  -- add'l ,2009,Appropriated,-157000,2321522,T-136
270,47th/State,South Side,2028-12-31,"Arterial streets ADA ramps design & construction  (min = 74,400 for design) ",2009,Appropriated,-511500,1810022,T-136
271,47th/State,South Side,2028-12-31,Cantor School ,2009,Committed,-150000,1660022,T-136
272,47th/State,South Side,2028-12-31,Estimated Incremental Property Tax Revenue ,2010,Committed,746669,2406691,T-136
273,47th/State,South Side,2028-12-31,Administrative Costs ,2010,Committed,-13400,2393291,T-136
274,47th/State,South Side,2028-12-31,Estimated Incremental Property Tax Revenue ,2011,Committed,746669,3139960,T-136
275,47th/State,South Side,2028-12-31,Administrative Costs ,2011,Committed,-13400,3126560,T-136
276,47th/State,South Side,2028-12-31,FY Beginning Cash Balance ,2009,Appropriated,2103103,2103103,T-136
277,47th/State,South Side,2028-12-31,Estimated Incremental Property Tax Revenue ,2010,Committed,165766,2268869,T-136
278,47th/State,South Side,2028-12-31,Administrative Costs ,2010,Committed,-10955,2257914,T-136
279,47th/State,South Side,2028-12-31,Estimated Incremental Property Tax Revenue ,2011,Committed,165766,2423681,T-136
280,47th/State,South Side,2028-12-31,Administrative Costs ,2011,Committed,-10955,2412726,T-136
281,63rd/Ashland,South Side,2030-12-31,FY Beginning Cash Balance ,2009,Appropriated,0,0,T-143
282,63rd/Ashland,South Side,2030-12-31,Administrative Costs ,2009,Committed,0,0,T-143
283,63rd/Ashland,South Side,2030-12-31,Demo @ 6826 S. Ashland ,2009,Committed,-19500,-19500,T-143
284,63rd/Ashland,South Side,2030-12-31,Demo @ 5541 S. Ashland ,2009,Committed,-20000,-39500,T-143
285,63rd/Ashland,South Side,2030-12-31,SBIF (-750k Auth.) ,2009,Committed,-750000,-789500,T-143
286,63rd/Ashland,South Side,2030-12-31,Neighborhood Improvement Program ,2009,Pending,-1000000,-1789500,T-143
287,63rd/Ashland,South Side,2030-12-31,Estimated Incremental Property Tax Revenue ,2010,Committed,0,-1789500,T-143
288,63rd/Ashland,South Side,2030-12-31,Estimated Incremental Property Tax Revenue ,2011,Committed,0,-1789500,T-143
289,63rd/Ashland,South Side,2030-12-31,FY Beginning Cash Balance ,2009,Appropriated,4954018,4954018,T-143
290,63rd/Ashland,South Side,2030-12-31,Estimated Incremental Property Tax Revenue ,2010,Committed,2109360,7063378,T-143
291,63rd/Ashland,South Side,2030-12-31,Administrative Costs ,2010,Committed,-35026,7028352,T-143
292,63rd/Ashland,South Side,2030-12-31,MSAC Ph.1 Debt Service 2010 - port to 51st/Archer - Southwest Elem. ,2010,Committed,-789081,6239271,T-143
293,63rd/Ashland,South Side,2030-12-31,Estimated Incremental Property Tax Revenue ,2011,Committed,2109360,8348631,T-143
294,63rd/Ashland,South Side,2030-12-31,Administrative Costs ,2011,Committed,-35026,8313605,T-143
295,63rd/Ashland,South Side,2030-12-31,SBIF Phase (-500k auth. Remaining) ,2011,Committed,-500000,7813605,T-143
296,63rd/Ashland,South Side,2030-12-31,MSAC Ph.1 Debt Service 2011 - port to 51st/Archer - Southwest Elem. ,2011,Committed,-996655,6816950,T-143
297,67th/Cicero,Southwest Side,2026-12-31,FY Beginning Cash Balance ,2009,Appropriated,307220,307220,T-124
298,67th/Cicero,Southwest Side,2026-12-31,SL Midway Payment 2009 ,2009,Appropriated,-251248,55972,T-124
299,67th/Cicero,Southwest Side,2026-12-31,Port from Greater SW IC West - Madigan Fields ,2009,Committed,2824023,2879995,T-124
300,67th/Cicero,Southwest Side,2026-12-31,Park #484/Madigan Fields Build out ,2009,Committed,-2824023,55972,T-124
301,67th/Cicero,Southwest Side,2026-12-31,Estimated Incremental Property Tax Revenue ,2010,Committed,308646,364618,T-124
302,67th/Cicero,Southwest Side,2026-12-31,Administrative Costs ,2010,Committed,-11916,352702,T-124
303,67th/Cicero,Southwest Side,2026-12-31,SL Midway Payment 2010 ,2010,Committed,-251248,101454,T-124
304,67th/Cicero,Southwest Side,2026-12-31,Estimated Incremental Property Tax Revenue ,2011,Committed,308646,410100,T-124
305,69th and Ashland,South Side,2028-12-31,FY Beginning Cash Balance ,2009,Appropriated,658528,658528,T-138
306,69th and Ashland,South Side,2028-12-31,"Finch, LP RDA ",2009,Appropriated,-170459,488069,T-138
307,69th and Ashland,South Side,2028-12-31,Ralph's Grocery RDA ,2009,Appropriated,-248437,239632,T-138
308,69th and Ashland,South Side,2028-12-31,Estimated Incremental Property Tax Revenue ,2010,Committed,58704,298336,T-138
309,69th and Ashland,South Side,2028-12-31,Administrative Costs ,2010,Committed,-1085,297251,T-138
310,69th and Ashland,South Side,2028-12-31,"Finch, LP RDA ",2010,Committed,-175000,122251,T-138
311,69th and Ashland,South Side,2028-12-31,Ralph's Grocery RDA ,2010,Committed,-250000,-127749,T-138
312,69th and Ashland,South Side,2028-12-31,Estimated Incremental Property Tax Revenue ,2011,Committed,58704,-69046,T-138
313,69th and Ashland,South Side,2028-12-31,Administrative Costs ,2011,Committed,-1085,-70131,T-138
314,69th and Ashland,South Side,2028-12-31,"Finch, LP RDA ",2011,Committed,-175000,-245131,T-138
315,69th and Ashland,South Side,2028-12-31,Ralph's Grocery RDA ,2011,Committed,-250000,-495131,T-138
316,69th and Ashland,South Side,2028-12-31,FY Beginning Cash Balance ,2009,Appropriated,3791670,3791670,T-138
317,69th and Ashland,South Side,2028-12-31,Relocation account ,2009,Appropriated,-21546,3770124,T-138
318,69th and Ashland,South Side,2028-12-31,Pre-acquisition account  -- add'l ,2009,Appropriated,-60000,3710124,T-138
319,69th and Ashland,South Side,2028-12-31,Demolition account increase ,2009,Appropriated,-64700,3645424,T-138
320,69th and Ashland,South Side,2028-12-31,"Arterial streets ADA ramps design & construction  (min = 37,200 for design) ",2009,Appropriated,-305500,3339924,T-138
321,69th and Ashland,South Side,2028-12-31,Acquisition budget adjustment ,2009,Appropriated,-372880,2967044,T-138
322,69th and Ashland,South Side,2028-12-31,Acquisiton 6830-6842 S Stony Island  -- add'l ,2009,Appropriated,-420000,2547044,T-138
323,69th and Ashland,South Side,2028-12-31,"Stony Island Bank Building: clean up, repair, property management costs ",2009,Committed,-75150,2471894,T-138
324,69th and Ashland,South Side,2028-12-31,Acquistion 6734 S. Stony Island ,2009,Committed,-300000,2171894,T-138
325,69th and Ashland,South Side,2028-12-31,Demolition increase ,2009,Committed,-526000,1645894,T-138
326,69th and Ashland,South Side,2028-12-31,Acquisition ,2009,Committed,-2100000,-454106,T-138
327,69th and Ashland,South Side,2028-12-31,Estimated Incremental Property Tax Revenue ,2010,Committed,3110242,2656136,T-138
328,69th and Ashland,South Side,2028-12-31,Administrative Costs ,2010,Committed,-53700,2602436,T-138
329,69th and Ashland,South Side,2028-12-31,Montclare RDA Note Debt Service Payment 2010 ,2010,Committed,-68500,2533936,T-138
330,69th and Ashland,South Side,2028-12-31,MSAC Ph.1 Debt Service 2010 - 71st/Stony Island share - S. Shore HS ,2010,Committed,-1524413,1009523,T-138
331,69th and Ashland,South Side,2028-12-31,Estimated Incremental Property Tax Revenue ,2011,Committed,3110242,4119765,T-138
332,69th and Ashland,South Side,2028-12-31,Administrative Costs ,2011,Committed,-53700,4066065,T-138
333,69th and Ashland,South Side,2028-12-31,Montclare RDA Note Debt Service Payment 2011 ,2011,Committed,-68500,3997565,T-138
334,69th and Ashland,South Side,2028-12-31,MSAC Ph.1 Debt Service 2011 - 71st/Stony Island share - S. Shore HS ,2011,Committed,-1723838,2273727,T-138
335,69th and Ashland,South Side,2028-12-31,FY Beginning Cash Balance ,2009,Appropriated,1752501,1752501,T-138
336,69th and Ashland,South Side,2028-12-31,Tootsie Roll Industries Note Payment ,2009,Committed,-147978,1604523,T-138
337,69th and Ashland,South Side,2028-12-31,Estimated Incremental Property Tax Revenue ,2010,Committed,291359,1895882,T-138
338,69th and Ashland,South Side,2028-12-31,Administrative Costs ,2010,Committed,-10409,1885473,T-138
339,69th and Ashland,South Side,2028-12-31,Tootsie Roll Industries Note Payment ,2010,Committed,-147978,1737495,T-138
340,69th and Ashland,South Side,2028-12-31,Estimated Incremental Property Tax Revenue ,2011,Committed,291359,2028854,T-138
341,69th and Ashland,South Side,2028-12-31,Administrative Costs ,2011,Committed,-10409,2018445,T-138
342,69th and Ashland,South Side,2028-12-31,Tootsie Roll Industries Note Payment ,2011,Committed,-155689,1862756,T-138
343,73rd & University,South Side,2016-11-17,FY Beginning Cash Balance ,2009,Appropriated,503560,503560,T-145
344,73rd & University,South Side,2016-11-17,Nabisco Payment ,2009,Committed,-300000,203560,T-145
345,73rd & University,South Side,2016-11-17,Estimated Incremental Property Tax Revenue ,2010,Committed,0,203560,T-145
346,73rd & University,South Side,2016-11-17,Administrative Costs ,2010,Committed,-6431,197128,T-145
347,73rd & University,South Side,2016-11-17,Nabisco Payment ,2010,Committed,-42976,154152,T-145
348,73rd & University,South Side,2016-11-17,Estimated Incremental Property Tax Revenue ,2011,Committed,0,154152,T-145
349,73rd & University,South Side,2016-11-17,Administrative Costs ,2011,Committed,-6431,147721,T-145
350,73rd & University,South Side,2016-11-17,Nabisco Payment ,2011,Committed,-42976,104745,T-145
351,73rd & University,South Side,2016-11-17,FY Beginning Cash Balance ,2009,Appropriated,695183,695183,T-145
352,73rd & University,South Side,2016-11-17,Estimated Incremental Property Tax Revenue ,2010,Committed,695000,1390183,T-145
353,73rd & University,South Side,2016-11-17,Estimated Incremental Property Tax Revenue ,2011,Committed,695000,2085183,T-145
354,79th/Cicero,Southwest Side,2029-12-31,FY Beginning Cash Balance ,2009,Appropriated,152917,152917,T-140
355,79th/Cicero,Southwest Side,2029-12-31,Professional Services Account - TIF Consultant Fees ,2009,Appropriated,-10000,142917,T-140
356,79th/Cicero,Southwest Side,2029-12-31,Administrative Costs ,2009,Committed,0,142917,T-140
357,79th/Cicero,Southwest Side,2029-12-31,Estimated Incremental Property Tax Revenue ,2010,Committed,162800,305717,T-140
358,79th/Cicero,Southwest Side,2029-12-31,Administrative Costs ,2010,Committed,0,305717,T-140
359,79th/Cicero,Southwest Side,2029-12-31,Estimated Incremental Property Tax Revenue ,2011,Committed,162800,468517,T-140
360,79th/Cicero,Southwest Side,2029-12-31,Administrative Costs ,2011,Committed,0,468517,T-140
361,79th/Cicero,Southwest Side,2029-12-31,FY Beginning Cash Balance ,2009,Appropriated,4056395,4056395,T-140
362,79th/Cicero,Southwest Side,2029-12-31,Wrightwood Senior Apts Payment @ 50% Completion ,2009,Appropriated,-1000000,3056395,T-140
363,79th/Cicero,Southwest Side,2029-12-31,Vertical clearance imrprovements: 79th & Leavitt ,2009,Committed,-606200,2450195,T-140
364,79th/Cicero,Southwest Side,2029-12-31,SBIF ,2009,Pending,-500000,1950195,T-140
365,79th/Cicero,Southwest Side,2029-12-31,ADA ramps  -- cost TBD ,2009,Proposed,0,1950195,T-140
366,79th/Cicero,Southwest Side,2029-12-31,"Lighting: 70th, Honore to Western ",2009,Proposed,-1750000,200195,T-140
367,79th/Cicero,Southwest Side,2029-12-31,Estimated Incremental Property Tax Revenue ,2010,Committed,724691,924886,T-140
368,79th/Cicero,Southwest Side,2029-12-31,Administrative Costs ,2010,Committed,-20000,904886,T-140
369,79th/Cicero,Southwest Side,2029-12-31,Wrightwood Senior Apts Payment @ 100% Completion ,2010,Committed,-950000,-45114,T-140
370,79th/Cicero,Southwest Side,2029-12-31,Wrightwood Senior Apts Payment @ 75% Completion ,2010,Committed,-1000000,-1045114,T-140
371,79th/Cicero,Southwest Side,2029-12-31,Estimated Incremental Property Tax Revenue ,2011,Committed,724691,-320423,T-140
372,79th/Cicero,Southwest Side,2029-12-31,Administrative Costs ,2011,Committed,-20000,-340423,T-140
373,79th/Vincennes,South Side,2031-12-31,FY Beginning Cash Balance ,2009,Appropriated,406023,406023,T-155
374,79th/Vincennes,South Side,2031-12-31,GO Reimbursement for TIF Eligiblity Study ,2009,Appropriated,-169399,236624,T-155
375,79th/Vincennes,South Side,2031-12-31,Estimated Incremental Property Tax Revenue ,2010,Committed,406000,642624,T-155
376,79th/Vincennes,South Side,2031-12-31,Estimated Incremental Property Tax Revenue ,2011,Committed,406000,1048624,T-155
377,79th/Vincennes,South Side,2031-12-31,FY Beginning Cash Balance ,2009,Appropriated,2723328,2723328,T-155
378,79th/Vincennes,South Side,2031-12-31,Glazier Pay-As-You-Go 2009 ,2009,Committed,-50000,2673328,T-155
379,79th/Vincennes,South Side,2031-12-31,Broadband Initiative ,2009,Committed,-347945,2325383,T-155
380,79th/Vincennes,South Side,2031-12-31,SBIF ,2009,Committed,-500000,1825383,T-155
381,79th/Vincennes,South Side,2031-12-31,A Gresham Plaza Retail LLC  -- 79th & Racine ,2009,Committed,-560000,1265383,T-155
382,79th/Vincennes,South Side,2031-12-31,Estimated Incremental Property Tax Revenue ,2010,Committed,690945,1956329,T-155
383,79th/Vincennes,South Side,2031-12-31,Administrative Costs ,2010,Committed,-13959,1942370,T-155
384,79th/Vincennes,South Side,2031-12-31,Glazier Pay-As-You-Go 2010 ,2010,Committed,-50000,1892370,T-155
385,79th/Vincennes,South Side,2031-12-31,Glazier Payment at Project Completion ,2010,Committed,-272500,1619870,T-155
386,79th/Vincennes,South Side,2031-12-31,Estimated Incremental Property Tax Revenue ,2011,Committed,690945,2310816,T-155
387,79th/Vincennes,South Side,2031-12-31,Administrative Costs ,2011,Committed,-13959,2296857,T-155
388,79th/Vincennes,South Side,2031-12-31,Glazier Pay-As-You-Go 2011 ,2011,Committed,-50000,2246857,T-155
389,83rd/Stewart,South Side,2028-12-31,FY Beginning Cash Balance ,2009,Appropriated,228546,228546,T-133
390,83rd/Stewart,South Side,2028-12-31,Professional Services - Project Review USE ,2009,Appropriated,-25000,203546,T-133
391,83rd/Stewart,South Side,2028-12-31,Estimated Incremental Property Tax Revenue ,2010,Committed,72787,276333,T-133
392,83rd/Stewart,South Side,2028-12-31,Administrative Costs ,2010,Committed,-4000,272333,T-133
393,83rd/Stewart,South Side,2028-12-31,Estimated Incremental Property Tax Revenue ,2011,Committed,72787,345120,T-133
394,83rd/Stewart,South Side,2028-12-31,Administrative Costs ,2011,Committed,-4000,341120,T-133
395,83rd/Stewart,South Side,2028-12-31,FY Beginning Cash Balance ,2009,Appropriated,4239983,4239983,T-133
396,83rd/Stewart,South Side,2028-12-31,Demolition: 7801 S. Cottage Grove Building ,2009,Appropriated,-75000,4164983,T-133
397,83rd/Stewart,South Side,2028-12-31,Whitney Young Library  -- 79th & King Drive: demo ,2009,Committed,-1000000,3164983,T-133
398,83rd/Stewart,South Side,2028-12-31,Broadband Initiative ,2009,Pending,-35195,3129788,T-133
399,83rd/Stewart,South Side,2028-12-31,Estimated Incremental Property Tax Revenue ,2010,Committed,1808744,4938532,T-133
400,83rd/Stewart,South Side,2028-12-31,Administrative Costs ,2010,Committed,-34400,4904132,T-133
401,83rd/Stewart,South Side,2028-12-31,MSAC Ph.1 Debt Service 2010 - port to 71st/Stony Island - S. Shore HS ,2010,Committed,-1285480,3618652,T-133
402,83rd/Stewart,South Side,2028-12-31,Estimated Incremental Property Tax Revenue ,2011,Committed,1808744,5427396,T-133
403,83rd/Stewart,South Side,2028-12-31,Administrative Costs ,2011,Committed,-34400,5392996,T-133
404,83rd/Stewart,South Side,2028-12-31,MSAC Ph.1 Debt Service 2011 - port to 71st/Stony Island - S. Shore HS ,2011,Committed,-1485068,3907927,T-133
405,83rd/Stewart,South Side,2028-12-31,FY Beginning Cash Balance ,2009,Appropriated,353662,353662,T-133
406,83rd/Stewart,South Side,2028-12-31,Chatham Club LLC Payment ,2009,Appropriated,-328662,25000,T-133
407,83rd/Stewart,South Side,2028-12-31,Estimated Incremental Property Tax Revenue ,2010,Committed,312400,337400,T-133
408,83rd/Stewart,South Side,2028-12-31,Administrative Costs ,2010,Committed,-9800,327600,T-133
409,83rd/Stewart,South Side,2028-12-31,Chatham Club LLC Payment ,2010,Committed,-328662,-1062,T-133
410,83rd/Stewart,South Side,2028-12-31,Estimated Incremental Property Tax Revenue ,2011,Committed,312400,311337,T-133
411,83rd/Stewart,South Side,2028-12-31,Administrative Costs ,2011,Committed,-9800,301537,T-133
412,83rd/Stewart,South Side,2028-12-31,Chatham Club LLC Payment ,2011,Committed,-328662,-27125,T-133
413,83rd/Stewart,South Side,2028-12-31,FY Beginning Cash Balance ,2009,Appropriated,3422870,3422870,T-133
414,83rd/Stewart,South Side,2028-12-31,Pre-acquisition account ,2009,Appropriated,-25000,3397870,T-133
415,83rd/Stewart,South Side,2028-12-31,95th & Stony LLC Note #2 payment  -- '09 ,2009,Appropriated,-245150,3152720,T-133
416,83rd/Stewart,South Side,2028-12-31,95th & Stony LLC Note #1 payment  -- '09 ,2009,Appropriated,-532450,2620270,T-133
417,83rd/Stewart,South Side,2028-12-31,Appraisal ,2009,Committed,-50000,2570270,T-133
418,83rd/Stewart,South Side,2028-12-31,Estimated Incremental Property Tax Revenue ,2010,Committed,1091937,3662207,T-133
419,83rd/Stewart,South Side,2028-12-31,Administrative Costs ,2010,Committed,-25000,3637207,T-133
420,83rd/Stewart,South Side,2028-12-31,95th & Stony LLC Note #2 payment  -- '10 ,2010,Committed,-264850,3372357,T-133
421,83rd/Stewart,South Side,2028-12-31,95th & Stony LLC Note #1 payment  -- '10 ,2010,Committed,-574150,2798207,T-133
422,83rd/Stewart,South Side,2028-12-31,Estimated Incremental Property Tax Revenue ,2011,Committed,1091937,3890144,T-133
423,83rd/Stewart,South Side,2028-12-31,Administrative Costs ,2011,Committed,-25000,3865144,T-133
424,83rd/Stewart,South Side,2028-12-31,95th & Stony LLC Note #2 payment  -- '11 ,2011,Committed,-261400,3603744,T-133
425,83rd/Stewart,South Side,2028-12-31,95th & Stony LLC Note #1 payment  -- '11 ,2011,Committed,-569100,3034644,T-133
426,83rd/Stewart,South Side,2028-12-31,FY Beginning Cash Balance ,2009,Appropriated,2346037,2346037,T-133
427,83rd/Stewart,South Side,2028-12-31,Pre-acquisition account increase ,2009,Appropriated,-50000,2296037,T-133
428,83rd/Stewart,South Side,2028-12-31,Planter replacement on 95th St.  -- w/o irrigation ,2009,Appropriated,-113587,2182450,T-133
429,83rd/Stewart,South Side,2028-12-31,"Streetscape master plan: 111th, Sacramento to Pulaski ",2009,Committed,-37500,2144950,T-133
430,83rd/Stewart,South Side,2028-12-31,"Bank Note Debt Service  -- Borders, SBIF -2009 - 1 of 4 payments remaining ",2009,Committed,-332650,1812300,T-133
431,83rd/Stewart,South Side,2028-12-31,"Lighting, sidewalks, planters (-900k from SBIF note proceeds) ",2009,Committed,-2100000,-287700,T-133
432,83rd/Stewart,South Side,2028-12-31,Estimated Incremental Property Tax Revenue ,2010,Committed,1043183,755483,T-133
433,83rd/Stewart,South Side,2028-12-31,Administrative Costs ,2010,Committed,-15000,740483,T-133
434,83rd/Stewart,South Side,2028-12-31,"Bank Note Debt Service  -- Borders, SBIF -2010 - 1 of 3 payments remaining ",2010,Committed,-332250,408233,T-133
435,83rd/Stewart,South Side,2028-12-31,Estimated Incremental Property Tax Revenue ,2011,Committed,1043183,1451416,T-133
436,83rd/Stewart,South Side,2028-12-31,Administrative Costs ,2011,Committed,-15000,1436416,T-133
437,83rd/Stewart,South Side,2028-12-31,95th Street Streetscaping Ashland to Western ,2011,Committed,-300000,1136416,T-133
438,83rd/Stewart,South Side,2028-12-31,"Bank Note Debt Service 2011  -- Borders, SBIF - 1 of 2 payments remaining ",2011,Committed,-330150,806266,T-133
439,Addison South,Northwest Side,2020-06-04,FY Beginning Cash Balance ,2009,Appropriated,6175936,6175936,T-150
440,Addison South,Northwest Side,2020-06-04,"Sidewalk repair: Addison, Francisco to California ",2009,Appropriated,-20556,6155380,T-150
441,Addison South,Northwest Side,2020-06-04,"Street lighting: Cornelia, Whipple to Sacramento ",2009,Appropriated,-35000,6120380,T-150
442,Addison South,Northwest Side,2020-06-04,"Street lighting: Whipple, Cornelia to Elston ",2009,Appropriated,-35000,6085380,T-150
443,Addison South,Northwest Side,2020-06-04,"Sidewalk repair: Belmont, Washtenaw to the River ",2009,Appropriated,-82973,6002407,T-150
444,Addison South,Northwest Side,2020-06-04,"Sidewalk repair: Roscoe, California to Elston ",2009,Appropriated,-261168,5741239,T-150
445,Addison South,Northwest Side,2020-06-04,Midway Games Inc. Note Payment ,2009,Committed,0,5741239,T-150
446,Addison South,Northwest Side,2020-06-04,Concrete bus pad: 2658 W. Belmont ,2009,Committed,-22700,5718539,T-150
447,Addison South,Northwest Side,2020-06-04,"Curb & Gutter, Sidewalk: Belmont, Washtenaw to River ",2009,Committed,-83146,5635393,T-150
448,Addison South,Northwest Side,2020-06-04,"Street resurfacing: Roscoe, California to Elston ",2009,Committed,-86460,5548933,T-150
449,Addison South,Northwest Side,2020-06-04,Estimated Incremental Property Tax Revenue ,2010,Committed,1623238,7172172,T-150
450,Addison South,Northwest Side,2020-06-04,Administrative Costs ,2010,Committed,-30100,7142072,T-150
451,Addison South,Northwest Side,2020-06-04,Estimated Incremental Property Tax Revenue ,2011,Committed,1623238,8765310,T-150
452,Addison South,Northwest Side,2020-06-04,Midway Games Inc. Note Payment ,2011,Committed,0,8765310,T-150
453,Addison South,Northwest Side,2020-06-04,Administrative Costs ,2011,Committed,-30100,8735210,T-150
454,Addison South,Northwest Side,2020-06-04,FY Beginning Cash Balance ,2009,Appropriated,1055411,1055411,T-150
455,Addison South,Northwest Side,2020-06-04,Professional services account ,2009,Appropriated,-45000,1010411,T-150
456,Addison South,Northwest Side,2020-06-04,Green Exchange ,2009,Committed,-250000,760411,T-150
457,Addison South,Northwest Side,2020-06-04,Small Business Improvement Fund ,2009,Pending,-250000,510411,T-150
458,Addison South,Northwest Side,2020-06-04,Neighborhood Improvement Fund ,2009,Pending,-1000000,-489589,T-150
459,Addison South,Northwest Side,2020-06-04,Estimated Incremental Property Tax Revenue ,2010,Committed,1000000,510411,T-150
460,Addison South,Northwest Side,2020-06-04,Administration  -- TBD ,2010,Committed,0,510411,T-150
461,Addison South,Northwest Side,2020-06-04,Estimated Incremental Property Tax Revenue ,2011,Committed,1000000,1510411,T-150
462,Addison South,Northwest Side,2020-06-04,Administration  -- TBD ,2011,Committed,0,1510411,T-150
463,Archer/Central,Southwest Side,2024-12-31,FY Beginning Cash Balance ,2009,Appropriated,3536528,3536528,T- 99
464,Archer/Central,Southwest Side,2024-12-31,Professional Services Account ,2009,Appropriated,-25000,3511528,T- 99
465,Archer/Central,Southwest Side,2024-12-31,Traffic signal @ Archer/Laramie ,2009,Appropriated,-350000,3161528,T- 99
466,Archer/Central,Southwest Side,2024-12-31,Acqusition account increase ,2009,Appropriated,-2222000,939528,T- 99
467,Archer/Central,Southwest Side,2024-12-31,Shop and Save Closing Payment ,2009,Committed,-300000,639528,T- 99
468,Archer/Central,Southwest Side,2024-12-31,"Parking lane repaving: 63rd St, Cicero to Kostner  -- split ",2009,Pending,-201055,438473,T- 99
469,Archer/Central,Southwest Side,2024-12-31,Estimated Incremental Property Tax Revenue ,2010,Committed,801337,1239810,T- 99
470,Archer/Central,Southwest Side,2024-12-31,Administrative Costs ,2010,Committed,-16238,1223572,T- 99
471,Archer/Central,Southwest Side,2024-12-31,PreAcquisition Services ,2010,Committed,-100000,1123572,T- 99
472,Archer/Central,Southwest Side,2024-12-31,Shop and Save Payment ,2010,Committed,-300000,823572,T- 99
473,Archer/Central,Southwest Side,2024-12-31,Estimated Incremental Property Tax Revenue ,2011,Committed,801337,1624910,T- 99
474,Archer/Central,Southwest Side,2024-12-31,Administrative Costs ,2011,Committed,-16238,1608672,T- 99
475,Archer/Central,Southwest Side,2024-12-31,Streetscaping Plan Cicero  -- 6400 - 6700 ,2011,Committed,-50000,1558672,T- 99
476,Archer/Central,Southwest Side,2024-12-31,Shop and Save Payment ,2011,Committed,-300000,1258672,T- 99
477,Archer/Central,Southwest Side,2024-12-31,FY Beginning Cash Balance ,2009,Appropriated,0,0,T- 99
478,Archer/Central,Southwest Side,2024-12-31,"Sreet resurfacing: S. Western Ave, 3100 to 3200 ",2009,On Hold,-44747,-44747,T- 99
479,Archer/Central,Southwest Side,2024-12-31,Estimated Incremental Property Tax Revenue ,2010,Committed,0,-44747,T- 99
480,Archer/Central,Southwest Side,2024-12-31,Estimated Incremental Property Tax Revenue ,2011,Committed,0,-44747,T- 99
481,Archer/Central,Southwest Side,2024-12-31,FY Beginning Cash Balance ,2009,Appropriated,995555,995555,T- 99
482,Archer/Central,Southwest Side,2024-12-31,"Stamped Concrete: Archer, Wentworth to Princeton ",2009,Appropriated,-2528,993027,T- 99
483,Archer/Central,Southwest Side,2024-12-31,"Arterial streets ADA ramps design & construction  (min = 12,400 for design) ",2009,Appropriated,-102000,891027,T- 99
484,Archer/Central,Southwest Side,2024-12-31,Community Housing Partners V Note Payment ,2009,Committed,-175000,716027,T- 99
485,Archer/Central,Southwest Side,2024-12-31,Estimated Incremental Property Tax Revenue ,2010,Committed,280344,996370,T- 99
486,Archer/Central,Southwest Side,2024-12-31,Administrative Costs ,2010,Committed,-5560,990810,T- 99
487,Archer/Central,Southwest Side,2024-12-31,Community Housing Partners V Note Payment ,2010,Committed,-175000,815810,T- 99
488,Archer/Central,Southwest Side,2024-12-31,Estimated Incremental Property Tax Revenue ,2011,Committed,280344,1096154,T- 99
489,Archer/Central,Southwest Side,2024-12-31,Administrative Costs ,2011,Committed,-5560,1090594,T- 99
490,Archer/Central,Southwest Side,2024-12-31,Community Housing Partners V Note Payment ,2011,Committed,-175000,915594,T- 99
491,Armitage and Pulaski,Northwest Side,2031-12-31,FY Beginning Cash Balance ,2009,Appropriated,221639,221639,T-151
492,Armitage and Pulaski,Northwest Side,2031-12-31,Pedestrian countdown signal @ N. Kostner & W. Armitage ,2009,Committed,-12000,209639,T-151
493,Armitage and Pulaski,Northwest Side,2031-12-31,"SBIF (1M auth., 750 remaining) ",2009,Committed,-250000,-40361,T-151
494,Armitage and Pulaski,Northwest Side,2031-12-31,Estimated Incremental Property Tax Revenue ,2010,Committed,221600,181239,T-151
495,Armitage and Pulaski,Northwest Side,2031-12-31,Estimated Incremental Property Tax Revenue ,2011,Committed,221600,402839,T-151
496,Austin Commercial,West Side,2031-12-31,FY Beginning Cash Balance ,2009,Appropriated,913478,913478,T-156
497,Austin Commercial,West Side,2031-12-31,Sidwalk: 4859 & 4909 W. Division ,2009,Appropriated,-15000,898478,T-156
498,Austin Commercial,West Side,2031-12-31,Bus pad: 4859 & 4909 W. Division ,2009,Appropriated,-33500,864978,T-156
499,Austin Commercial,West Side,2031-12-31,Safe Routes to School match @ San Miguel Elem. ,2009,Appropriated,-40000,824978,T-156
500,Austin Commercial,West Side,2031-12-31,"SBIF (750k auth., 250k remaining) ",2009,Appropriated,-500000,324978,T-156
501,Austin Commercial,West Side,2031-12-31,Administrative Costs ,2009,Committed,0,324978,T-156
502,Austin Commercial,West Side,2031-12-31,"SBIF (750k auth., 0 remaining) ",2009,Committed,-250000,74978,T-156
503,Austin Commercial,West Side,2031-12-31,Broadband Initiative ,2009,Pending,-113507,-38529,T-156
504,Austin Commercial,West Side,2031-12-31,"Neighborhood Impr. Prgm. (500k auth., 250 reamaining) ",2009,Pending,-250000,-288529,T-156
505,Austin Commercial,West Side,2031-12-31,Estimated Incremental Property Tax Revenue ,2010,Committed,913000,624471,T-156
506,Austin Commercial,West Side,2031-12-31,Administrative Costs ,2010,Committed,0,624471,T-156
507,Austin Commercial,West Side,2031-12-31,Estimated Incremental Property Tax Revenue ,2011,Committed,913000,1537471,T-156
508,Austin Commercial,West Side,2031-12-31,Administrative Costs ,2011,Committed,0,1537471,T-156
509,Avalon Park/South Shore,South Side,2026-12-31,FY Beginning Cash Balance ,2009,Appropriated,1744477,1744477,T-123
510,Avalon Park/South Shore,South Side,2026-12-31,"SBIF (500k auth., 0 remaining) ",2009,Committed,-500000,1244477,T-123
511,Avalon Park/South Shore,South Side,2026-12-31,"Streetscape- Exchange77th to 79th Place; 79th, Exchange to Marquette ",2009,Committed,-500000,744477,T-123
512,Avalon Park/South Shore,South Side,2026-12-31,Estimated Incremental Property Tax Revenue ,2010,Committed,646605,1391082,T-123
513,Avalon Park/South Shore,South Side,2026-12-31,Administrative Costs ,2010,Committed,-12300,1378782,T-123
514,Avalon Park/South Shore,South Side,2026-12-31,MSAC Ph.1 Debt Service 2010 - port to 71st/Stony Island - S. Shore HS ,2010,Committed,-375884,1002899,T-123
515,Avalon Park/South Shore,South Side,2026-12-31,Estimated Incremental Property Tax Revenue ,2011,Committed,646605,1649503,T-123
516,Avalon Park/South Shore,South Side,2026-12-31,Administrative Costs ,2011,Committed,-12300,1637203,T-123
517,Avalon Park/South Shore,South Side,2026-12-31,MSAC Ph.1 Debt Service 2011 - port to 71st/Stony Island - S. Shore HS ,2011,Committed,-452181,1185022,T-123
518,Belmont/Central,Northwest Side,2024-12-31,FY Beginning Cash Balance ,2009,Appropriated,4884202,4884202,T- 81
519,Belmont/Central,Northwest Side,2024-12-31,Pedestrian countdown signal @ Diversey & Central ,2009,Appropriated,-12000,4872202,T- 81
520,Belmont/Central,Northwest Side,2024-12-31,"Diagonal parking @ Lorel Ave, Fullerton to 1st alley south ",2009,Appropriated,-30000,4842202,T- 81
521,Belmont/Central,Northwest Side,2024-12-31,"Lighting: Central, Diversey to Barry  -- add'l ",2009,Appropriated,-64000,4778202,T- 81
522,Belmont/Central,Northwest Side,2024-12-31,"Lighting: Central, Diversy to Barry ",2009,Appropriated,-550000,4228202,T- 81
523,Belmont/Central,Northwest Side,2024-12-31,Sidewalks / trees  -- add'l ,2009,Committed,-16807,4211395,T- 81
524,Belmont/Central,Northwest Side,2024-12-31,"New Sidewalk: Central Ave, Diversey to George ",2009,Committed,-238450,3972944,T- 81
525,Belmont/Central,Northwest Side,2024-12-31,"New Sidewalk: Central Ave, George to Wellington ",2009,Committed,-277774,3695170,T- 81
526,Belmont/Central,Northwest Side,2024-12-31,"Ornamental lighting: Cetnral, Diversey to Fullteron ",2009,Committed,-1300000,2395170,T- 81
527,Belmont/Central,Northwest Side,2024-12-31,Estimated Incremental Property Tax Revenue ,2010,Committed,2710939,5106109,T- 81
528,Belmont/Central,Northwest Side,2024-12-31,Administrative Costs ,2010,Committed,-51600,5054509,T- 81
529,Belmont/Central,Northwest Side,2024-12-31,MSAC Ph.1 Debt Service 2010 - port to Galewood/Armitage - Belmont Cragin ,2010,Committed,-211642,4842867,T- 81
530,Belmont/Central,Northwest Side,2024-12-31,Estimated Incremental Property Tax Revenue ,2011,Committed,2710939,7553806,T- 81
531,Belmont/Central,Northwest Side,2024-12-31,Administrative Costs ,2011,Committed,-51600,7502206,T- 81
532,Belmont/Central,Northwest Side,2024-12-31,MSAC Ph.1 Debt Service 2011 - port to Galewood/Armitage - Belmont Cragin ,2011,Committed,-247491,7254715,T- 81
533,Belmont/Cicero,Northwest Side,2024-12-31,FY Beginning Cash Balance ,2009,Appropriated,1995839,1995839,T- 82
534,Belmont/Cicero,Northwest Side,2024-12-31,Traffic signal @ Belmont / Lamon ,2009,Appropriated,-350000,1645839,T- 82
535,Belmont/Cicero,Northwest Side,2024-12-31,Pre-Acquisition Accounts ,2009,Committed,-50000,1595839,T- 82
536,Belmont/Cicero,Northwest Side,2024-12-31,Estimated Incremental Property Tax Revenue ,2010,Committed,1155333,2751172,T- 82
537,Belmont/Cicero,Northwest Side,2024-12-31,Administrative Costs ,2010,Committed,-20000,2731172,T- 82
538,Belmont/Cicero,Northwest Side,2024-12-31,Senior Suites of Kelvyn Park ,2010,Committed,-150000,2581172,T- 82
539,Belmont/Cicero,Northwest Side,2024-12-31,Open Space Landscaping ,2010,Pending,-20000,2561172,T- 82
540,Belmont/Cicero,Northwest Side,2024-12-31,Estimated Incremental Property Tax Revenue ,2011,Committed,1155333,3716505,T- 82
541,Belmont/Cicero,Northwest Side,2024-12-31,Administrative Costs ,2011,Committed,-20000,3696505,T- 82
542,Belmont/Cicero,Northwest Side,2024-12-31,Senior Suites of Kelvyn Park ,2011,Committed,-150000,3546505,T- 82
543,Bronzeville,South Side,2022-12-31,FY Beginning Cash Balance ,2009,Appropriated,16321921,16321921,T- 61
544,Bronzeville,South Side,2022-12-31,Lighting: Federal to Prairie ,2009,Appropriated,-64000,16257921,T- 61
545,Bronzeville,South Side,2022-12-31,"Sidewalks/Pkwy restoration/ tree installation: Michigan Ave, 37th Pl to 37th St ",2009,Appropriated,-152789,16105132,T- 61
546,Bronzeville,South Side,2022-12-31,South Park Plaza / Prairie Courts Debt Service  (need amt.) ,2009,Committed,0,16105132,T- 61
547,Bronzeville,South Side,2022-12-31,Pre-acquisition account ,2009,Committed,-50000,16055132,T- 61
548,Bronzeville,South Side,2022-12-31,Dunbar Park ,2009,Committed,-1000000,15055132,T- 61
549,Bronzeville,South Side,2022-12-31,Metropolis RDA ,2009,Committed,-1100000,13955132,T- 61
550,Bronzeville,South Side,2022-12-31,Broadband Initiative ,2009,Pending,-1048004,12907127,T- 61
551,Bronzeville,South Side,2022-12-31,Right of way improvements: 37th St to 37th Place ,2009,Requested,-80000,12827127,T- 61
552,Bronzeville,South Side,2022-12-31,Estimated Incremental Property Tax Revenue ,2010,Committed,3439288,16266416,T- 61
553,Bronzeville,South Side,2022-12-31,South Park Plaza / Prairie Courts Debt Service  (need  amt.) ,2010,Committed,0,16266416,T- 61
554,Bronzeville,South Side,2022-12-31,Pershing Courts Debt Service  (need  amt.) ,2010,Committed,0,16266416,T- 61
555,Bronzeville,South Side,2022-12-31,Administrative Costs ,2010,Committed,-65500,16200916,T- 61
556,Bronzeville,South Side,2022-12-31,Estimated Incremental Property Tax Revenue ,2011,Committed,3439288,19640204,T- 61
557,Bronzeville,South Side,2022-12-31,South Park Plaza / Prairie Courts Debt Service  (need  amt.) ,2011,Committed,0,19640204,T- 61
558,Bronzeville,South Side,2022-12-31,Pershing Courts Debt Service  (need amt.) ,2011,Committed,0,19640204,T- 61
559,Bronzeville,South Side,2022-12-31,Administrative Costs ,2011,Committed,-65500,19574704,T- 61
560,Bryn Mawr/Broadway,North Side,2019-12-11,FY Beginning Cash Balance ,2009,Appropriated,4892836,4892836,T- 13
561,Bryn Mawr/Broadway,North Side,2019-12-11,RTA Planning Grant ,2009,Appropriated,-16667,4876169,T- 13
562,Bryn Mawr/Broadway,North Side,2019-12-11,Banners for Bryn Mawr Historic District ,2009,Appropriated,-146803,4729366,T- 13
563,Bryn Mawr/Broadway,North Side,2019-12-11,Broman Park Env. Clean-up ,2009,Appropriated,-168000,4561366,T- 13
564,Bryn Mawr/Broadway,North Side,2019-12-11,Port to Hollywood/Sheridan for SBIF ,2009,Appropriated,-250000,4311366,T- 13
565,Bryn Mawr/Broadway,North Side,2019-12-11,"Arterial streets ADA ramps design & construction  (min = 68,200 for design) ",2009,Appropriated,-359000,3952366,T- 13
566,Bryn Mawr/Broadway,North Side,2019-12-11,Pre-Acquisition Account ,2009,Committed,-50000,3902366,T- 13
567,Bryn Mawr/Broadway,North Side,2019-12-11,5556 N. Sheridan - Additional Utility Relocation Costs  -- non BOE ,2009,Committed,-56393,3845973,T- 13
568,Bryn Mawr/Broadway,North Side,2019-12-11,Good Taste Bakery ,2009,Committed,-59650,3786323,T- 13
569,Bryn Mawr/Broadway,North Side,2019-12-11,"SBIF (750 auth., 500 prev. released, 0 remaining) ",2009,Committed,-250000,3536323,T- 13
570,Bryn Mawr/Broadway,North Side,2019-12-11,Nookies ,2009,Committed,-300000,3236323,T- 13
571,Bryn Mawr/Broadway,North Side,2019-12-11,Bank Note Debt Service  -- Final Payment ,2009,Committed,-410000,2826323,T- 13
572,Bryn Mawr/Broadway,North Side,2019-12-11,Port to Hollywood/Sheridan  -- acquisition for Edgewater library ,2009,Committed,-1125000,1701323,T- 13
573,Bryn Mawr/Broadway,North Side,2019-12-11,Bromann Park playground ,2009,Pending,-350000,1351323,T- 13
574,Bryn Mawr/Broadway,North Side,2019-12-11,Estimated Incremental Property Tax Revenue ,2010,Committed,1308073,2659396,T- 13
575,Bryn Mawr/Broadway,North Side,2019-12-11,Administrative Costs ,2010,Committed,-25000,2634396,T- 13
576,Bryn Mawr/Broadway,North Side,2019-12-11,Estimated Incremental Property Tax Revenue ,2011,Committed,1308073,3942468,T- 13
577,Bryn Mawr/Broadway,North Side,2019-12-11,Administrative Costs ,2011,Committed,-25000,3917468,T- 13
578,Bryn Mawr/Broadway,North Side,2019-12-11,FY Beginning Cash Balance ,2009,Appropriated,58969690,58969690,T- 13
579,Bryn Mawr/Broadway,North Side,2019-12-11,Estimated Incremental Property Tax Revenue ,2010,Committed,9545820,68515510,T- 13
580,Bryn Mawr/Broadway,North Side,2019-12-11,Administrative Costs ,2010,Committed,-226850,68288660,T- 13
581,Bryn Mawr/Broadway,North Side,2019-12-11,Potential Redevelopment Project ,2010,Proposed,-60000000,8288660,T- 13
582,Bryn Mawr/Broadway,North Side,2019-12-11,Estimated Incremental Property Tax Revenue ,2011,Committed,9545820,17834480,T- 13
583,Bryn Mawr/Broadway,North Side,2019-12-11,Administrative Costs ,2011,Committed,-226850,17607630,T- 13
584,Canal St/Congress Expy,Central,2022-12-31,FY Beginning Cash Balance ,2009,Appropriated,35801820,35801820,T- 63
585,Canal St/Congress Expy,Central,2022-12-31,555 W. Monroe RDA  -- Little Note payment ,2009,Appropriated,-123221,35678599,T- 63
586,Canal St/Congress Expy,Central,2022-12-31,Central Business District Underground Mapping Intiative Phase 3 ,2009,Appropriated,-176215,35502384,T- 63
587,Canal St/Congress Expy,Central,2022-12-31,US Fitness LLC Payment for 09 ,2009,Appropriated,-280659,35221725,T- 63
588,Canal St/Congress Expy,Central,2022-12-31,Lighting around Union Station ,2009,Appropriated,-600000,34621725,T- 63
589,Canal St/Congress Expy,Central,2022-12-31,Viaduct Jackson Blvd  -- add'l ,2009,Appropriated,-634000,33987725,T- 63
590,Canal St/Congress Expy,Central,2022-12-31,550 W. Jackson LLC Note Payment ,2009,Appropriated,-911949,33075775,T- 63
591,Canal St/Congress Expy,Central,2022-12-31,550 W. Adams LLC Note Payment ,2009,Appropriated,-1087315,31988461,T- 63
592,Canal St/Congress Expy,Central,2022-12-31,Union Station Intermodal Transporation Center acquisition ,2009,Appropriated,-1386000,30602461,T- 63
593,Canal St/Congress Expy,Central,2022-12-31,Sidewalks around: Union Station ,2009,Appropriated,-1500000,29102461,T- 63
594,Canal St/Congress Expy,Central,2022-12-31,Vaulted sidewalk fill-in: 208 S. Jefferson ,2009,Committed,-82254,29020207,T- 63
595,Canal St/Congress Expy,Central,2022-12-31,Estimated Incremental Property Tax Revenue ,2010,Committed,18595286,47615493,T- 63
596,Canal St/Congress Expy,Central,2022-12-31,555 W. Monroe RDA  -- Little Note payment  -- est ,2010,Committed,-121150,47494343,T- 63
597,Canal St/Congress Expy,Central,2022-12-31,Administrative Costs ,2010,Committed,-307600,47186743,T- 63
598,Canal St/Congress Expy,Central,2022-12-31,550 W. Jackson LLC Note Payment  -- est ,2010,Committed,-912000,46274743,T- 63
599,Canal St/Congress Expy,Central,2022-12-31,550 W. Adams LLC Note Payment  -- est ,2010,Committed,-1100000,45174743,T- 63
600,Canal St/Congress Expy,Central,2022-12-31,Port to River South for Ping Tom Park - 2010 ,2010,Committed,-10000000,35174743,T- 63
601,Canal St/Congress Expy,Central,2022-12-31,Port to River South for Wells St. Project A  -- 15th - 18th Construction ,2010,Pending,-8000000,27174743,T- 63
602,Canal St/Congress Expy,Central,2022-12-31,Estimated Incremental Property Tax Revenue ,2011,Committed,18595286,45770029,T- 63
603,Canal St/Congress Expy,Central,2022-12-31,555 W. Monroe RDA  -- Little Note payment  -- est ,2011,Committed,-121150,45648879,T- 63
604,Canal St/Congress Expy,Central,2022-12-31,Administrative Costs ,2011,Committed,-307600,45341279,T- 63
605,Canal St/Congress Expy,Central,2022-12-31,550 W. Jackson LLC Note Payment  -- est ,2011,Committed,-912000,44429279,T- 63
606,Canal St/Congress Expy,Central,2022-12-31,550 W. Adams LLC Note Payment  -- est ,2011,Committed,-1100000,43329279,T- 63
607,Canal St/Congress Expy,Central,2022-12-31,Port to River South for Wells St. Project B. ,2011,Pending,-25000000,18329279,T- 63
608,Central West,Central,2024-12-31,FY Beginning Cash Balance ,2009,Appropriated,20574876,20574876,T- 86
609,Central West,Central,2024-12-31,Demo @ 2335 W. Madison ,2009,Appropriated,-19800,20555076,T- 86
610,Central West,Central,2024-12-31,Community Reinvestment Fund ,2009,Appropriated,-106171,20448905,T- 86
611,Central West,Central,2024-12-31,Acquisition account increase ,2009,Appropriated,-132561,20316344,T- 86
612,Central West,Central,2024-12-31,"Lighting: Washington & Warren, Western to Damen ",2009,Appropriated,-135000,20181344,T- 86
613,Central West,Central,2024-12-31,"Lighting: Ashland, Eisenhower Exp to Madison ",2009,Appropriated,-200000,19981344,T- 86
614,Central West,Central,2024-12-31,Community Reinvestment Fund Account ,2009,Appropriated,-235153,19746191,T- 86
615,Central West,Central,2024-12-31,Acquisition account increase for 2342-50 W. Monroe ,2009,Appropriated,-276137,19470054,T- 86
616,Central West,Central,2024-12-31,950 W. Monroe Note Payment  -- 2009 ,2009,Appropriated,-377893,19092161,T- 86
617,Central West,Central,2024-12-31,"Lighting: Monroe, Jackson, and Adams near Loomis ",2009,Appropriated,-475000,18617161,T- 86
618,Central West,Central,2024-12-31,"Resurfacing: Warren, Western to Damen ",2009,Appropriated,-890000,17727161,T- 86
619,Central West,Central,2024-12-31,Women's Treatment Center RDA ,2009,Appropriated,-1000000,16727161,T- 86
620,Central West,Central,2024-12-31,Streetscape: Western Ave. Phase 2 ,2009,Appropriated,-2000000,14727161,T- 86
621,Central West,Central,2024-12-31,Port from Nearl West  -- Sangamon Park Phase I Construction ,2009,Committed,4000000,18727161,T- 86
622,Central West,Central,2024-12-31,Port from Near West for Adams/Sangamon Park Phase I Add'l Work ,2009,Committed,4000000,22727161,T- 86
623,Central West,Central,2024-12-31,Monroe/Sangamon Phase II Acquisition  -- 901-3 W. Monroe add'l ,2009,Committed,-15000,22712161,T- 86
624,Central West,Central,2024-12-31,"Lighting: VanBuren, Halsted to Racine ",2009,Committed,-105000,22607161,T- 86
625,Central West,Central,2024-12-31,TIF Plan Amendment ,2009,Committed,-150000,22457161,T- 86
626,Central West,Central,2024-12-31,Parcel 8-13; 15 S. Western ,2009,Committed,-250000,22207161,T- 86
627,Central West,Central,2024-12-31,Acquisition Reserve ,2009,Committed,-597500,21609661,T- 86
628,Central West,Central,2024-12-31,Parcel 427-1/2 2536-48 Madison ,2009,Committed,-720000,20889661,T- 86
629,Central West,Central,2024-12-31,"Streetscape: Western Ave.  -- Ph. 1, Van Buren to Monroe  -- constr. ",2009,Committed,-2000000,18889661,T- 86
630,Central West,Central,2024-12-31,"CPS ADA projects  -- Brown, Cregier ",2009,Committed,-2250250,16639411,T- 86
631,Central West,Central,2024-12-31,Adams/Sangamon Phase I Demo/ Envir./ Build-out ,2009,Committed,-4000000,12639411,T- 86
632,Central West,Central,2024-12-31,Sangamon Park Phase I Construction ,2009,Committed,-4000000,8639411,T- 86
633,Central West,Central,2024-12-31,Rush RDA payment no. 1 ,2009,Committed,-8728000,-88589,T- 86
634,Central West,Central,2024-12-31,TIF Share of Madison/Western Sale Proceeds ,2009,Pending,0,-88589,T- 86
635,Central West,Central,2024-12-31,Acquisition: 33 S. Western Ave. ,2009,Pending,-20000,-108589,T- 86
636,Central West,Central,2024-12-31,Traffic Study; West Loop Parking Study ,2009,Pending,-210000,-318589,T- 86
637,Central West,Central,2024-12-31,Estimated Incremental Property Tax Revenue ,2010,Committed,10067913,9749324,T- 86
638,Central West,Central,2024-12-31,Port from Near West  -- Monroe/Sangamon Phase II Demo / Envr. / Buildout ,2010,Committed,2000000,11749324,T- 86
639,Central West,Central,2024-12-31,Administrative Costs ,2010,Committed,-191500,11557824,T- 86
640,Central West,Central,2024-12-31,MSAC Ph.1 Debt Service 2010 - Central West share - Skinner Elem. ,2010,Committed,-671650,10886174,T- 86
641,Central West,Central,2024-12-31,"Street resurfacing: Madison, Western to Damen ",2010,Committed,-890000,9996174,T- 86
642,Central West,Central,2024-12-31,Monroe/Sangamon Phase II Demo / Envr. / Buildout ,2010,Committed,-2000000,7996174,T- 86
643,Central West,Central,2024-12-31,Rush RDA payment no.2 ,2010,Committed,-14224950,-6228776,T- 86
644,Central West,Central,2024-12-31,Land Disposition ,2010,Pending,-250000,-6478776,T- 86
645,Central West,Central,2024-12-31,Skinner Park  -- Tot Lot Playground ,2010,Pending,-500000,-6978776,T- 86
646,Central West,Central,2024-12-31,Union Park Improvements ,2010,Pending,-1000000,-7978776,T- 86
647,Central West,Central,2024-12-31,Lighting along Washington-27th Ward ,2010,Pending,-2000000,-9978776,T- 86
648,Central West,Central,2024-12-31,Estimated Incremental Property Tax Revenue ,2011,Committed,10067913,89136,T- 86
649,Central West,Central,2024-12-31,"Lighting: VanBuren, Ogden to Western ",2011,Committed,-120000,-30864,T- 86
650,Central West,Central,2024-12-31,Administrative Costs ,2011,Committed,-191500,-222364,T- 86
651,Central West,Central,2024-12-31,"Stamped Crosswalk: Washington, Western to Damen ",2011,Committed,-200000,-422364,T- 86
652,Central West,Central,2024-12-31,MSAC Ph.1 Debt Service 2011 - Central West share - Skinner Elem. ,2011,Committed,-717499,-1139863,T- 86
653,Central West,Central,2024-12-31,"Street resurfacing: VanBuren, Damen to Ashland ",2011,Committed,-890000,-2029863,T- 86
654,Central West,Central,2024-12-31,"Street resurfacing: Washtington, Western to Damen ",2011,Committed,-890000,-2919863,T- 86
655,Central West,Central,2024-12-31,WHP Park ,2011,Committed,-1000000,-3919863,T- 86
656,Central West,Central,2024-12-31,"Street resurfacing: VanBuren, Laflin to Loomis ",2011,Committed,-2043000,-5962863,T- 86
657,Central West,Central,2024-12-31,Rush RDA payment no. 3 ,2011,Committed,-7421400,-13384263,T- 86
658,Central West,Central,2024-12-31,Land Disposition ,2011,Pending,-200000,-13584263,T- 86
659,Central West,Central,2024-12-31,Viceroy Hotel ,2011,Pending,-5000000,-18584263,T- 86
660,Chatham Ridge,South Side,2010-12-31,FY Beginning Cash Balance ,2009,Appropriated,2540191,2540191,T- 15
661,Chatham Ridge,South Side,2010-12-31,Sales Tax Increment ,2009,Appropriated,1500000,4040191,T- 15
662,Chatham Ridge,South Side,2010-12-31,"Est. Property Tax Collections  -- 2008 levy, received 2009 ",2009,Committed,1628476,5668667,T- 15
663,Chatham Ridge,South Side,2010-12-31,Decorative Stamped Concrete - 87th/Holland Vertical Clearance ,2009,Committed,-69375,5599292,T- 15
664,Chatham Ridge,South Side,2010-12-31,Simeon High School Debt Service 2009 ,2009,Committed,-1800000,3799292,T- 15
665,Chatham Ridge,South Side,2010-12-31,"Bond Debt Service due in 2010  -- 1 of 4 remaining, last payment due 2013 ",2009,Committed,-2127383,1671909,T- 15
666,Chatham Ridge,South Side,2010-12-31,"Est. Property Tax Collections  -- 2009 levy, received 2010 ",2010,Committed,1628476,3300385,T- 15
667,Chatham Ridge,South Side,2010-12-31,Sales Tax Increment ,2010,Committed,1500000,4800385,T- 15
668,Chatham Ridge,South Side,2010-12-31,Administrative Costs ,2010,Committed,-67050,4733335,T- 15
669,Chatham Ridge,South Side,2010-12-31,Simeon High School Debt Service 2010 ,2010,Committed,-1800000,2933335,T- 15
670,Chatham Ridge,South Side,2010-12-31,"Bond Debt Service due in 2011 -- 1 of 3 remaining, last payment due 2013 ",2010,Committed,-2355263,578072,T- 15
671,Chicago/Central Park,Northwest Side,2026-12-31,FY Beginning Cash Balance ,2009,Appropriated,14168923,14168923,T-115
672,Chicago/Central Park,Northwest Side,2026-12-31,Demolition account increase ,2009,Appropriated,-13500,14155423,T-115
673,Chicago/Central Park,Northwest Side,2026-12-31,Diagonal parking @ Kildare ,2009,Appropriated,-35734,14119689,T-115
674,Chicago/Central Park,Northwest Side,2026-12-31,"SBIF (1.5M auth., 500k remaining) ",2009,Appropriated,-1000000,13119689,T-115
675,Chicago/Central Park,Northwest Side,2026-12-31,Breakthrough Urban Ministries ,2009,Appropriated,-1153961,11965728,T-115
676,Chicago/Central Park,Northwest Side,2026-12-31,Payoff of Outstanding Bank Note Balance ,2009,Committed,-664000,11301728,T-115
677,Chicago/Central Park,Northwest Side,2026-12-31,CPS ADA projects  -- Ryerson ,2009,Committed,-750000,10551728,T-115
678,Chicago/Central Park,Northwest Side,2026-12-31,Neighborhood Imprv. Prgm. ,2009,Committed,-1500000,9051728,T-115
679,Chicago/Central Park,Northwest Side,2026-12-31,Disposition Services--Franklin/Whipple/Chicago/Kedzie ,2009,Pending,-150000,8901728,T-115
680,Chicago/Central Park,Northwest Side,2026-12-31,Broadband Initiative ,2009,Pending,-611405,8290322,T-115
681,Chicago/Central Park,Northwest Side,2026-12-31,27th Ward Yard Improvements  -- renovation of building ,2009,Requested,-2000000,6290322,T-115
682,Chicago/Central Park,Northwest Side,2026-12-31,Estimated Incremental Property Tax Revenue ,2010,Committed,4704930,10995253,T-115
683,Chicago/Central Park,Northwest Side,2026-12-31,Administrative Costs ,2010,Committed,-89500,10905753,T-115
684,Chicago/Central Park,Northwest Side,2026-12-31,Rosa Parks Note 1 Payment ,2010,Committed,-225000,10680753,T-115
685,Chicago/Central Park,Northwest Side,2026-12-31,MSAC Ph.1 Debt Service 2010 - Chicago/Central Park share - Westinghouse ,2010,Committed,-987018,9693735,T-115
686,Chicago/Central Park,Northwest Side,2026-12-31,Potential Redevelopment Project ,2010,Pending,-300000,9393735,T-115
687,Chicago/Central Park,Northwest Side,2026-12-31,Potential Redevelopment Project ,2010,Pending,-400000,8993735,T-115
688,Chicago/Central Park,Northwest Side,2026-12-31,LUCHA - affordable rental ,2010,Pending,-2000000,6993735,T-115
689,Chicago/Central Park,Northwest Side,2026-12-31,Estimated Incremental Property Tax Revenue ,2011,Committed,4704930,11698665,T-115
690,Chicago/Central Park,Northwest Side,2026-12-31,Administrative Costs ,2011,Committed,-89500,11609165,T-115
691,Chicago/Central Park,Northwest Side,2026-12-31,Rosa Parks Note Payment ,2011,Committed,-150000,11459165,T-115
692,Chicago/Central Park,Northwest Side,2026-12-31,MSAC Ph.1 Debt Service 2011 - Chicago/Central Park share - Westinghouse ,2011,Committed,-959658,10499508,T-115
693,Chicago/Kingsbury,Central,2024-12-31,FY Beginning Cash Balance ,2009,Appropriated,17208976,17208976,T- 94
694,Chicago/Kingsbury,Central,2024-12-31,E-Port Payment  -- Note A - 2009 ,2009,Appropriated,-3119800,14089176,T- 94
695,Chicago/Kingsbury,Central,2024-12-31,E-Port Payment  -- Note B - 2009 ,2009,Appropriated,-3500000,10589176,T- 94
696,Chicago/Kingsbury,Central,2024-12-31,Railroad track removal: Erie Street ,2009,Committed,-55000,10534176,T- 94
697,Chicago/Kingsbury,Central,2024-12-31,Railroad track removal: Ohio Street ,2009,Committed,-70000,10464176,T- 94
698,Chicago/Kingsbury,Central,2024-12-31,Professional Services-Study ,2009,Pending,-70000,10394176,T- 94
699,Chicago/Kingsbury,Central,2024-12-31,Estimated Incremental Property Tax Revenue ,2010,Committed,10765416,21159592,T- 94
700,Chicago/Kingsbury,Central,2024-12-31,Barry Callebaut Payment ,2010,Committed,-176000,20983592,T- 94
701,Chicago/Kingsbury,Central,2024-12-31,Administrative Costs ,2010,Committed,-176000,20807592,T- 94
702,Chicago/Kingsbury,Central,2024-12-31,Infinium HQ RDA ,2010,Committed,-205300,20602292,T- 94
703,Chicago/Kingsbury,Central,2024-12-31,E-Port Payment  -- Note A - 2010 ,2010,Committed,-3275260,17327032,T- 94
704,Chicago/Kingsbury,Central,2024-12-31,E-Port Payment  -- Note B - 2010 ,2010,Committed,-3500000,13827032,T- 94
705,Chicago/Kingsbury,Central,2024-12-31,Estimated Incremental Property Tax Revenue ,2011,Committed,10765416,24592448,T- 94
706,Chicago/Kingsbury,Central,2024-12-31,Barry Callebaut Payment ,2011,Committed,-176000,24416448,T- 94
707,Chicago/Kingsbury,Central,2024-12-31,Administrative Costs ,2011,Committed,-176000,24240448,T- 94
708,Chicago/Kingsbury,Central,2024-12-31,Infinium HQ RDA ,2011,Committed,-205300,24035148,T- 94
709,Chicago/Kingsbury,Central,2024-12-31,E-Port Payment  -- Note A - 2011 ,2011,Committed,-3611010,20424138,T- 94
710,Chinatown Basin,Central,2010-12-31,FY Beginning Cash Balance ,2009,Appropriated,9606207,9606207,T- 16
711,Chinatown Basin,Central,2010-12-31,"Stamped Concrete: Archer, Wentworth to Princeton ",2009,Appropriated,-44246,9561961,T- 16
712,Chinatown Basin,Central,2010-12-31,"Est. Property Tax Collections  -- 2008 levy, received 2009 ",2009,Committed,2218076,11780038,T- 16
713,Chinatown Basin,Central,2010-12-31,Chinatown Planning Study ,2009,Committed,-74030,11706008,T- 16
714,Chinatown Basin,Central,2010-12-31,"Street grading, Wentworth, 18th to 20th ",2009,Committed,-187200,11518808,T- 16
715,Chinatown Basin,Central,2010-12-31,"Est. Property Tax Collections  -- 2009 levy, received 2010 ",2010,Committed,2218076,13736884,T- 16
716,Chinatown Basin,Central,2010-12-31,Administrative Costs ,2010,Committed,-97000,13639884,T- 16
717,Chinatown Basin,Central,2010-12-31,Port to River South TIF for Ping Tom Park Expansion ,2010,Committed,-2000000,11639884,T- 16
718,Chinatown Basin,Central,2010-12-31,Port to 24th/Michigan for Wentworth Ave. Connector  -- Design ,2010,Pending,-500000,11139884,T- 16
719,Chinatown Basin,Central,2010-12-31,Port to 24th/Michigan for Red Line Chinatown Stop improvements ,2010,Pending,-600000,10539884,T- 16
720,Cicero/Archer,Southwest Side,2024-12-31,FY Beginning Cash Balance ,2009,Appropriated,2611269,2611269,T- 96
721,Cicero/Archer,Southwest Side,2024-12-31,Pre-Acquisition ,2009,Pending,-50000,2561269,T- 96
722,Cicero/Archer,Southwest Side,2024-12-31,Pre-Acquisition ,2009,Pending,-50000,2511269,T- 96
723,Cicero/Archer,Southwest Side,2024-12-31,Estimated Incremental Property Tax Revenue ,2010,Committed,833823,3345093,T- 96
724,Cicero/Archer,Southwest Side,2024-12-31,Administrative Costs ,2010,Committed,-18000,3327093,T- 96
725,Cicero/Archer,Southwest Side,2024-12-31,Estimated Incremental Property Tax Revenue ,2011,Committed,833823,4160916,T- 96
726,Cicero/Archer,Southwest Side,2024-12-31,Administrative Costs ,2011,Committed,-18000,4142916,T- 96
727,Clark/Montrose,North Side,2022-07-07,FY Beginning Cash Balance ,2009,Appropriated,4720337,4720337,T- 70
728,Clark/Montrose,North Side,2022-07-07,Port from Western Ave. North re: Clark Streetscape ,2009,Appropriated,2000000,6720337,T- 70
729,Clark/Montrose,North Side,2022-07-07,"Arterial streets ADA ramps design & construction  (min = 62,000 for design) ",2009,Appropriated,-394000,6326337,T- 70
730,Clark/Montrose,North Side,2022-07-07,Black Ensemble Theater Debt Service 2009 ,2009,Appropriated,-469700,5856637,T- 70
731,Clark/Montrose,North Side,2022-07-07,"Streetscape: Clark St. , Montrose to Ainslie ",2009,Appropriated,-6312986,-456349,T- 70
732,Clark/Montrose,North Side,2022-07-07,Chase Park imrovements ,2009,Pending,-200000,-656349,T- 70
733,Clark/Montrose,North Side,2022-07-07,Estimated Incremental Property Tax Revenue ,2010,Committed,1863796,1207447,T- 70
734,Clark/Montrose,North Side,2022-07-07,Administrative Costs ,2010,Committed,-31000,1176447,T- 70
735,Clark/Montrose,North Side,2022-07-07,Black Ensemble Theater Debt Service 2010 ,2010,Committed,-469700,706747,T- 70
736,Clark/Montrose,North Side,2022-07-07,SBIF ,2010,Committed,-500000,206747,T- 70
737,Clark/Montrose,North Side,2022-07-07,Estimated Incremental Property Tax Revenue ,2011,Committed,1863796,2070543,T- 70
738,Clark/Montrose,North Side,2022-07-07,Administrative Costs ,2011,Committed,-31000,2039543,T- 70
739,Clark/Montrose,North Side,2022-07-07,Black Ensemble Theater Debt Service 2011 ,2011,Committed,-844700,1194843,T- 70
740,Clark/Ridge,North Side,2022-09-29,FY Beginning Cash Balance ,2009,Appropriated,4619014,4619014,T- 74
741,Clark/Ridge,North Side,2022-09-29,1818 West Peterson Affordable Housing payment Feb 2009 ,2009,Appropriated,-635875,3983139,T- 74
742,Clark/Ridge,North Side,2022-09-29,SBIF: 1.75 M (auth. less 600k prev. less 250k = 1.15M remaining) ,2009,Committed,-250000,3733139,T- 74
743,Clark/Ridge,North Side,2022-09-29,24th District Police Station Air Handlers - remaining ,2009,Committed,-607000,3126139,T- 74
744,Clark/Ridge,North Side,2022-09-29,Senn High School Auditorium ,2009,Committed,-1000000,2126139,T- 74
745,Clark/Ridge,North Side,2022-09-29,24th District Police Station repairs  -- full recon ,2009,Requested,-2543000,-416861,T- 74
746,Clark/Ridge,North Side,2022-09-29,Estimated Incremental Property Tax Revenue ,2010,Committed,1510045,1093184,T- 74
747,Clark/Ridge,North Side,2022-09-29,Administrative Costs ,2010,Committed,-28700,1064484,T- 74
748,Clark/Ridge,North Side,2022-09-29,1818 West Peterson Affordable Housing-payment Feb 2010 ,2010,Committed,-635875,428609,T- 74
749,Clark/Ridge,North Side,2022-09-29,Estimated Incremental Property Tax Revenue ,2011,Committed,1510045,1938654,T- 74
750,Clark/Ridge,North Side,2022-09-29,Administrative Costs ,2011,Committed,-28700,1909954,T- 74
751,Clark/Ridge,North Side,2022-09-29,1818 West Peterson Affordable Housing-payment Feb 2011 ,2011,Committed,-635875,1274079,T- 74
752,Commercial Avenue,South Side,2026-12-31,FY Beginning Cash Balance ,2009,Appropriated,5838795,5838795,T-128
753,Commercial Avenue,South Side,2026-12-31,"Diagonal parking: Commercial Ave., 97th to 98th ",2009,Appropriated,-68491,5770303,T-128
754,Commercial Avenue,South Side,2026-12-31,"Sidewalks: Commercial Ave., 97th to 98th ",2009,Appropriated,-107292,5663011,T-128
755,Commercial Avenue,South Side,2026-12-31,"Street resurfacing: 97th, Commercial to first alley west ",2009,Committed,-17380,5645631,T-128
756,Commercial Avenue,South Side,2026-12-31,Commercial Avenue Retail Market Study ,2009,Committed,-40000,5605631,T-128
757,Commercial Avenue,South Side,2026-12-31,SBIF (1.5 authorized) ,2009,Committed,-1500000,4105631,T-128
758,Commercial Avenue,South Side,2026-12-31,"Diagonal Parking on Commercial Avenue; 97th Street, 88th Street and 88th/Houston ",2009,Pending,-195000,3910631,T-128
759,Commercial Avenue,South Side,2026-12-31,Ornamental Lighting: 91st - 93rd Commercial Avenue ,2009,Pending,-300000,3610631,T-128
760,Commercial Avenue,South Side,2026-12-31,Estimated Incremental Property Tax Revenue ,2010,Committed,1682645,5293276,T-128
761,Commercial Avenue,South Side,2026-12-31,Administrative Costs ,2010,Committed,-26600,5266676,T-128
762,Commercial Avenue,South Side,2026-12-31,TIFWorks Job Training ,2010,Pending,-75000,5191676,T-128
763,Commercial Avenue,South Side,2026-12-31,Sidewalk Replacement: 88th & Commercial ,2010,Pending,-155000,5036676,T-128
764,Commercial Avenue,South Side,2026-12-31,Estimated Incremental Property Tax Revenue ,2011,Committed,1682645,6719321,T-128
765,Commercial Avenue,South Side,2026-12-31,Administrative Costs ,2011,Committed,-26600,6692721,T-128
766,Devon/Sheridan,North Side,2028-12-31,FY Beginning Cash Balance ,2009,Appropriated,692335,692335,T-134
767,Devon/Sheridan,North Side,2028-12-31,SBIF  -- add'l ,2009,Appropriated,-25000,667335,T-134
768,Devon/Sheridan,North Side,2028-12-31,"UG II, LLC  -- Uncommon Ground RA ",2009,Committed,-103447,563888,T-134
769,Devon/Sheridan,North Side,2028-12-31,TIF Note Series 2007A Debt Service - 2009 - 1 of 3 payments remaining ,2009,Committed,-142000,421888,T-134
770,Devon/Sheridan,North Side,2028-12-31,Estimated Incremental Property Tax Revenue ,2010,Committed,307663,729551,T-134
771,Devon/Sheridan,North Side,2028-12-31,Administrative Costs ,2010,Committed,-5860,723691,T-134
772,Devon/Sheridan,North Side,2028-12-31,Loyola Mundelein Center ,2010,Committed,-65000,658691,T-134
773,Devon/Sheridan,North Side,2028-12-31,UGII  -- Uncommon Ground RA ,2010,Committed,-103447,555244,T-134
774,Devon/Sheridan,North Side,2028-12-31,TIF Note Series 2007A Debt Service - 2010 - 1 of 2 payments remaining ,2010,Committed,-152358,402886,T-134
775,Devon/Sheridan,North Side,2028-12-31,6610 N. Sheridan - Inverbrass Funds RDA payment @ completion ,2010,Pending,-300000,102886,T-134
776,Devon/Sheridan,North Side,2028-12-31,Neigh. Imp. Prgm./SBIF Program ,2010,Pending,-1500000,-1397114,T-134
777,Devon/Sheridan,North Side,2028-12-31,Estimated Incremental Property Tax Revenue ,2011,Committed,307663,-1089451,T-134
778,Devon/Sheridan,North Side,2028-12-31,Administrative Costs ,2011,Committed,-5860,-1095311,T-134
779,Devon/Sheridan,North Side,2028-12-31,Loyola Mundelein Center ,2011,Committed,-32453,-1127764,T-134
780,Devon/Sheridan,North Side,2028-12-31,"UG II, LLC  -- Uncommon Ground RA ",2011,Committed,-103447,-1231211,T-134
781,Devon/Sheridan,North Side,2028-12-31,TIF Neigh. Imp. Prgm. Note Series 2007A Debt Service - 2011 - final payment ,2011,Committed,-143715,-1374926,T-134
782,Devon/Western,North Side,2023-12-31,FY Beginning Cash Balance ,2009,Appropriated,4749930,4749930,T- 76
783,Devon/Western,North Side,2023-12-31,Pre-Acquisition Account ,2009,Committed,-50000,4699930,T- 76
784,Devon/Western,North Side,2023-12-31,Estimated Incremental Property Tax Revenue ,2010,Committed,2644255,7344185,T- 76
785,Devon/Western,North Side,2023-12-31,Administrative Costs ,2010,Committed,-32000,7312185,T- 76
786,Devon/Western,North Side,2023-12-31,MSAC Ph.1 Debt Service 2010 - port to Touhy/Western - Boone Clinton ,2010,Committed,-379339,6932846,T- 76
787,Devon/Western,North Side,2023-12-31,Potential Redevelopment Project ,2010,Pending,-3000000,3932846,T- 76
788,Devon/Western,North Side,2023-12-31,Estimated Incremental Property Tax Revenue ,2011,Committed,2644255,6577101,T- 76
789,Devon/Western,North Side,2023-12-31,Administrative Costs ,2011,Committed,-32000,6545101,T- 76
790,Devon/Western,North Side,2023-12-31,Devon-Rockwell Garage ,2011,Committed,-419746,6125355,T- 76
791,Devon/Western,North Side,2023-12-31,MSAC Ph.1 Debt Service 2011 - port to Touhy/Western - Boone Clinton ,2011,Committed,-436206,5689148,T- 76
792,Diversey/Narragansett,Northwest Side,2027-12-31,FY Beginning Cash Balance ,2009,Appropriated,3535551,3535551,T-129
793,Diversey/Narragansett,Northwest Side,2027-12-31,Brickyard Project Note 2 ,2009,Appropriated,-15123,3520428,T-129
794,Diversey/Narragansett,Northwest Side,2027-12-31,Brickyard RDA Note 1 ,2009,Appropriated,-1619700,1900728,T-129
795,Diversey/Narragansett,Northwest Side,2027-12-31,RIIS Park: new playground and turf ,2009,Pending,-1000000,900728,T-129
796,Diversey/Narragansett,Northwest Side,2027-12-31,Estimated Incremental Property Tax Revenue ,2010,Committed,2290118,3190846,T-129
797,Diversey/Narragansett,Northwest Side,2027-12-31,Brickyard Project Note 2 ,2010,Committed,-15123,3175723,T-129
798,Diversey/Narragansett,Northwest Side,2027-12-31,Administrative Costs ,2010,Committed,-33200,3142523,T-129
799,Diversey/Narragansett,Northwest Side,2027-12-31,Brickyard RDA Note 1 ,2010,Committed,-1619700,1522823,T-129
800,Diversey/Narragansett,Northwest Side,2027-12-31,Estimated Incremental Property Tax Revenue ,2011,Committed,2290118,3812941,T-129
801,Diversey/Narragansett,Northwest Side,2027-12-31,Brickyard Project Note 2 ,2011,Committed,-15123,3797818,T-129
802,Diversey/Narragansett,Northwest Side,2027-12-31,Administrative Costs ,2011,Committed,-33200,3764618,T-129
803,Diversey/Narragansett,Northwest Side,2027-12-31,Brickyard RDA Note 1 ,2011,Committed,-1619700,2144918,T-129
804,Division/Homan,Northwest Side,2025-12-31,FY Beginning Cash Balance ,2009,Appropriated,2482276,2482276,T-107
805,Division/Homan,Northwest Side,2025-12-31,Demolition reimbursement ,2009,Appropriated,-8300,2473976,T-107
806,Division/Homan,Northwest Side,2025-12-31,Pre-Acquisition Account ,2009,Committed,-50000,2423976,T-107
807,Division/Homan,Northwest Side,2025-12-31,LaEstancia Ph. II & III ,2009,Committed,-201371,2222605,T-107
808,Division/Homan,Northwest Side,2025-12-31,Payoff of Outstanding Bank Note Balance ,2009,Committed,-446000,1776605,T-107
809,Division/Homan,Northwest Side,2025-12-31,IPRAC RDA ,2009,Committed,-446480,1330125,T-107
810,Division/Homan,Northwest Side,2025-12-31,Broadband Initiative ,2009,Pending,-196157,1133968,T-107
811,Division/Homan,Northwest Side,2025-12-31,Neighborhood Improvement Fund ,2009,Pending,-500000,633968,T-107
812,Division/Homan,Northwest Side,2025-12-31,Estimated Incremental Property Tax Revenue ,2010,Committed,1126165,1760133,T-107
813,Division/Homan,Northwest Side,2025-12-31,Administrative Costs ,2010,Committed,-20600,1739533,T-107
814,Division/Homan,Northwest Side,2025-12-31,LaEstancia Ph. II & III ,2010,Committed,-201371,1538162,T-107
815,Division/Homan,Northwest Side,2025-12-31,"SBIF (1M auth., 500k remaining) ",2010,Pending,-500000,1038162,T-107
816,Division/Homan,Northwest Side,2025-12-31,Estimated Incremental Property Tax Revenue ,2011,Committed,1126165,2164328,T-107
817,Division/Homan,Northwest Side,2025-12-31,Administrative Costs ,2011,Committed,-20600,2143728,T-107
818,Division/Homan,Northwest Side,2025-12-31,Neigh. Imp. Prgm. Note Debt Service ,2011,Committed,-188292,1955436,T-107
819,Division/Homan,Northwest Side,2025-12-31,LaEstancia Ph. II & III ,2011,Committed,-201371,1754065,T-107
820,Division/Hooker,Northwest Side,2019-07-10,FY Beginning Cash Balance ,2009,Appropriated,1126155,1126155,T- 17
821,Division/Hooker,Northwest Side,2019-07-10,Estimated Incremental Property Tax Revenue ,2010,Committed,218121,1344276,T- 17
822,Division/Hooker,Northwest Side,2019-07-10,Federal Express Corp. Note Payment ,2010,Committed,0,1344276,T- 17
823,Division/Hooker,Northwest Side,2019-07-10,Administrative Costs ,2010,Committed,-8500,1335776,T- 17
824,Division/Hooker,Northwest Side,2019-07-10,Estimated Incremental Property Tax Revenue ,2011,Committed,218121,1553897,T- 17
825,Division/Hooker,Northwest Side,2019-07-10,Federal Express Corp. Note Payment ,2011,Committed,0,1553897,T- 17
826,Division/Hooker,Northwest Side,2019-07-10,Administrative Costs ,2011,Committed,-8500,1545397,T- 17
827,Division/North Branch,Northwest Side,2014-03-15,FY Beginning Cash Balance ,2009,Appropriated,26730,26730,T- 18
828,Division/North Branch,Northwest Side,2014-03-15,Estimated Incremental Property Tax Revenue ,2010,Committed,131314,158044,T- 18
829,Division/North Branch,Northwest Side,2014-03-15,Administrative Costs ,2010,Committed,-7500,150544,T- 18
830,Division/North Branch,Northwest Side,2014-03-15,Series 1991 Bond Debt Service 2010  -- 1 of 2 remaining ,2010,Committed,-273625,-123081,T- 18
831,Division/North Branch,Northwest Side,2014-03-15,Estimated Incremental Property Tax Revenue ,2011,Committed,131314,8233,T- 18
832,Division/North Branch,Northwest Side,2014-03-15,Administrative Costs ,2011,Committed,-7500,733,T- 18
833,Division/North Branch,Northwest Side,2014-03-15,Series 1991 Bond Debt Service 2011  -- final payment ,2011,Committed,-270000,-269267,T- 18
834,Drexel Boulevard,South Side,2026-12-31,FY Beginning Cash Balance ,2009,Appropriated,343367,343367,T-122
835,Drexel Boulevard,South Side,2026-12-31,Jazz on the Boulevard ,2009,Appropriated,-343367,0,T-122
836,Drexel Boulevard,South Side,2026-12-31,Administrative Costs ,2009,Committed,0,0,T-122
837,Drexel Boulevard,South Side,2026-12-31,Pre-Acquisition ,2009,Committed,-10000,-10000,T-122
838,Drexel Boulevard,South Side,2026-12-31,Estimated Incremental Property Tax Revenue ,2010,Committed,225111,215111,T-122
839,Drexel Boulevard,South Side,2026-12-31,Administrative Costs ,2010,Committed,0,215111,T-122
840,Drexel Boulevard,South Side,2026-12-31,Estimated Incremental Property Tax Revenue ,2011,Committed,225111,440222,T-122
841,Drexel Boulevard,South Side,2026-12-31,Jazz on the Boulevard ,2011,Committed,0,440222,T-122
842,Drexel Boulevard,South Side,2026-12-31,43rd & Drexel ,2011,Pending,0,440222,T-122
843,Eastman/North Branch,Northwest Side,2016-10-07,FY Beginning Cash Balance ,2009,Appropriated,1041880,1041880,T- 19
844,Eastman/North Branch,Northwest Side,2016-10-07,Estimated Incremental Property Tax Revenue ,2010,Committed,208284,1250164,T- 19
845,Eastman/North Branch,Northwest Side,2016-10-07,Administrative Costs ,2010,Committed,-8625,1241539,T- 19
846,Eastman/North Branch,Northwest Side,2016-10-07,Estimated Incremental Property Tax Revenue ,2011,Committed,208284,1449823,T- 19
847,Eastman/North Branch,Northwest Side,2016-10-07,Administrative Costs ,2011,Committed,-8625,1441198,T- 19
848,Edgewater,North Side,2009-12-18,FY Beginning Cash Balance ,2009,Appropriated,1379315,1379315,T- 20
849,Edgewater,North Side,2009-12-18,Liquidation of unexpended budgets ,2009,Appropriated,116244,1495559,T- 20
850,Edgewater,North Side,2009-12-18,Port to Lawrence / Broadway for SBIF ,2009,Appropriated,-250000,1245559,T- 20
851,Edgewater,North Side,2009-12-18,IGA / CTA for Berwyn stop ,2009,Committed,-1173768,71791,T- 20
852,Edgewater,North Side,2009-12-18,Estimated Incremental Property Tax Revenue ,2010,Committed,0,71791,T- 20
853,Edgewater,North Side,2009-12-18,Estimated Incremental Property Tax Revenue ,2011,Committed,0,71791,T- 20
854,Edgewater/Ashland,North Side,2027-12-31,FY Beginning Cash Balance ,2009,Appropriated,3618098,3618098,T-130
855,Edgewater/Ashland,North Side,2027-12-31,Estimated Incremental Property Tax Revenue ,2010,Committed,292256,3910353,T-130
856,Edgewater/Ashland,North Side,2027-12-31,Administrative Costs ,2010,Committed,-27400,3882953,T-130
857,Edgewater/Ashland,North Side,2027-12-31,Estimated Incremental Property Tax Revenue ,2011,Committed,292256,4175209,T-130
858,Edgewater/Ashland,North Side,2027-12-31,Administrative Costs ,2011,Committed,-27400,4147809,T-130
859,Edgewater/Ashland,North Side,2027-12-31,FY Beginning Cash Balance ,2009,Appropriated,347052,347052,T-130
860,Edgewater/Ashland,North Side,2027-12-31,"SBIF (750k auth., 500k remaining) ",2009,Appropriated,-250000,97052,T-130
861,Edgewater/Ashland,North Side,2027-12-31,Farnsworth Open Space/ Campus Design ,2009,Committed,-100000,-2948,T-130
862,Edgewater/Ashland,North Side,2027-12-31,Estimated Incremental Property Tax Revenue ,2010,Committed,347000,344052,T-130
863,Edgewater/Ashland,North Side,2027-12-31,Estimated Incremental Property Tax Revenue ,2011,Committed,347000,691052,T-130
864,Englewood Neighborhood,South Side,2012-11-29,FY Beginning Cash Balance ,2009,Appropriated,5114810,5114810,T-106
865,Englewood Neighborhood,South Side,2012-11-29,Pre-Acquisition ,2009,Appropriated,-20000,5094810,T-106
866,Englewood Neighborhood,South Side,2012-11-29,Lakefront SRO/Mercy Supportive Housing ,2009,Appropriated,-2000000,3094810,T-106
867,Englewood Neighborhood,South Side,2012-11-29,Estimated Incremental Property Tax Revenue ,2010,Committed,481786,3576597,T-106
868,Englewood Neighborhood,South Side,2012-11-29,Administrative Costs ,2010,Committed,-15383,3561214,T-106
869,Englewood Neighborhood,South Side,2012-11-29,63rd Plaza Improvements ,2010,Committed,-50000,3511214,T-106
870,Englewood Neighborhood,South Side,2012-11-29,Estimated Incremental Property Tax Revenue ,2011,Committed,481786,3993000,T-106
871,Englewood Neighborhood,South Side,2012-11-29,Administrative Costs ,2011,Committed,-15383,3977617,T-106
872,Englewood Neighborhood,South Side,2012-11-29,FY Beginning Cash Balance ,2009,Appropriated,14567807,14567807,T-106
873,Englewood Neighborhood,South Side,2012-11-29,Englewood Plaza ,2009,Appropriated,-100000,14467807,T-106
874,Englewood Neighborhood,South Side,2012-11-29,Pre-acquisition acct. increase ,2009,Appropriated,-100000,14367807,T-106
875,Englewood Neighborhood,South Side,2012-11-29,Professional Services - Acquisition Expenses ,2009,Committed,-50000,14317807,T-106
876,Englewood Neighborhood,South Side,2012-11-29,Open Space: remediation of sidewalk vaults ,2009,Committed,-100000,14217807,T-106
877,Englewood Neighborhood,South Side,2012-11-29,LISC Neigh. Imp. Prgm. Debt Service ,2009,Committed,-132375,14085432,T-106
878,Englewood Neighborhood,South Side,2012-11-29,5961-65 South Halsted Acquisition ,2009,Committed,-198000,13887432,T-106
879,Englewood Neighborhood,South Side,2012-11-29,"CPS ADA projects  -- Holmes, Mays, Nicholson ",2009,Committed,-2250000,11637432,T-106
880,Englewood Neighborhood,South Side,2012-11-29,IGA-CBE: Holmes Elem. Renovations ,2009,Committed,-2470000,9167432,T-106
881,Englewood Neighborhood,South Side,2012-11-29,Broadband Initiative ,2009,Pending,-1232819,7934614,T-106
882,Englewood Neighborhood,South Side,2012-11-29,Estimated Incremental Property Tax Revenue ,2010,Committed,4291190,12225804,T-106
883,Englewood Neighborhood,South Side,2012-11-29,ECDC Note Payment ,2010,Committed,0,12225804,T-106
884,Englewood Neighborhood,South Side,2012-11-29,Administrative Costs ,2010,Committed,-73500,12152304,T-106
885,Englewood Neighborhood,South Side,2012-11-29,LISC Neigh. Imp. Prgm. Debt Service ,2010,Committed,-148875,12003429,T-106
886,Englewood Neighborhood,South Side,2012-11-29,RDA: 63rd/Halsted Shopping Center - Ultra Foods - cash payment ,2010,Committed,-6000000,6003429,T-106
887,Englewood Neighborhood,South Side,2012-11-29,Estimated Incremental Property Tax Revenue ,2011,Committed,4291190,10294619,T-106
888,Englewood Neighborhood,South Side,2012-11-29,RDA: 63rd/Halsted Shopping Center - Ultra Foods - note payment  -- amt TBD ,2011,Committed,0,10294619,T-106
889,Englewood Neighborhood,South Side,2012-11-29,ECDC Note Payment ,2011,Committed,0,10294619,T-106
890,Englewood Neighborhood,South Side,2012-11-29,Administrative Costs ,2011,Committed,-73500,10221119,T-106
891,Englewood Neighborhood,South Side,2012-11-29,LISC Neigh. Imp. Prgm. Debt Service ,2011,Committed,-163250,10057869,T-106
892,Fullerton/Milwaukee,Northwest Side,2024-12-31,FY Beginning Cash Balance ,2009,Appropriated,9373294,9373294,T- 87
893,Fullerton/Milwaukee,Northwest Side,2024-12-31,Historic lighting fixture @ Logan Square Comfort Station ,2009,Appropriated,-6000,9367294,T- 87
894,Fullerton/Milwaukee,Northwest Side,2024-12-31,Pedestrian countdown signal @ Milwaukee / Pulaski ,2009,Appropriated,-12000,9355294,T- 87
895,Fullerton/Milwaukee,Northwest Side,2024-12-31,Pedestrian countdown signal @ Milwaukee / Belmont ,2009,Appropriated,-12000,9343294,T- 87
896,Fullerton/Milwaukee,Northwest Side,2024-12-31,Alley resurfacing: Altgeld/ Fullerton/ Sawyer/ Spaulding ,2009,Appropriated,-28493,9314801,T- 87
897,Fullerton/Milwaukee,Northwest Side,2024-12-31,"Green Alley: Belmont, Springfield to Harding ",2009,Appropriated,-29000,9285801,T- 87
898,Fullerton/Milwaukee,Northwest Side,2024-12-31,Pre-acquisition account increase ,2009,Appropriated,-30000,9255801,T- 87
899,Fullerton/Milwaukee,Northwest Side,2024-12-31,Left turn signals: Kimball/ Diversey/ Milwaukee ,2009,Appropriated,-50000,9205801,T- 87
900,Fullerton/Milwaukee,Northwest Side,2024-12-31,"Lighting: Milwaukee, Western - California  -- pole painting & piggybacks ",2009,Appropriated,-68100,9137701,T- 87
901,Fullerton/Milwaukee,Northwest Side,2024-12-31,Demolition reimbursement ,2009,Committed,-13499,9124202,T- 87
902,Fullerton/Milwaukee,Northwest Side,2024-12-31,"Diagonal parking, pavement marking, bench  -- Centenial monument ",2009,Committed,-170000,8954202,T- 87
903,Fullerton/Milwaukee,Northwest Side,2024-12-31,Floresheim Completion Payout ,2009,Committed,-500000,8454202,T- 87
904,Fullerton/Milwaukee,Northwest Side,2024-12-31,SBIF  -- round 3 ,2009,Committed,-2000000,6454202,T- 87
905,Fullerton/Milwaukee,Northwest Side,2024-12-31,Port to Avondale TIF for SBIF ,2009,Pending,-1000000,5454202,T- 87
906,Fullerton/Milwaukee,Northwest Side,2024-12-31,Estimated Incremental Property Tax Revenue ,2010,Committed,4377277,9831480,T- 87
907,Fullerton/Milwaukee,Northwest Side,2024-12-31,Administrative Costs ,2010,Committed,-83300,9748180,T- 87
908,Fullerton/Milwaukee,Northwest Side,2024-12-31,Florsheim Rehab RDA payment  -- est. ,2010,Committed,-93500,9654680,T- 87
909,Fullerton/Milwaukee,Northwest Side,2024-12-31,MSAC Ph.1 Debt Service 2010 - Avondale/Irving Park ,2010,Committed,-587175,9067505,T- 87
910,Fullerton/Milwaukee,Northwest Side,2024-12-31,Sachs Hairpin Lofts payments during construction ,2010,Pending,-3500000,5567505,T- 87
911,Fullerton/Milwaukee,Northwest Side,2024-12-31,Estimated Incremental Property Tax Revenue ,2011,Committed,4377277,9944782,T- 87
912,Fullerton/Milwaukee,Northwest Side,2024-12-31,Administrative Costs ,2011,Committed,-83300,9861482,T- 87
913,Fullerton/Milwaukee,Northwest Side,2024-12-31,Florsheim Rehab RDA payment  -- est. ,2011,Committed,-93500,9767982,T- 87
914,Fullerton/Milwaukee,Northwest Side,2024-12-31,MSAC Ph.1 Debt Service 2011 - Avondale/Irving Park ,2011,Committed,-669775,9098207,T- 87
915,Fullerton/Milwaukee,Northwest Side,2024-12-31,Sachs Hairpin Lofts payment for retail portion ,2011,Pending,-1210000,7888207,T- 87
916,Fullerton/Milwaukee,Northwest Side,2024-12-31,Sachs Hairpin Lofts payment at completion ,2011,Pending,-2400000,5488207,T- 87
917,Fullerton/Milwaukee,Northwest Side,2024-12-31,CPS IGA for ADA Ph. 2  (TPC = 3M w/ CPS match of 500k) ,2011,Pending,-2500000,2988207,T- 87
918,Galewood/Armitage,Northwest Side,2022-07-07,FY Beginning Cash Balance ,2009,Appropriated,4359203,4359203,T- 71
919,Galewood/Armitage,Northwest Side,2022-07-07,Pre-acquisition account increase ,2009,Appropriated,-50000,4309203,T- 71
920,Galewood/Armitage,Northwest Side,2022-07-07,MOWD MOU for RFS ,2009,Committed,-19600,4289603,T- 71
921,Galewood/Armitage,Northwest Side,2022-07-07,"Resurfacing: Homer, Laramie to Leclaire ",2009,Committed,-250000,4039603,T- 71
922,Galewood/Armitage,Northwest Side,2022-07-07,Potential Redevelopment Project ,2009,Committed,-1100000,2939603,T- 71
923,Galewood/Armitage,Northwest Side,2022-07-07,Broadband Initiative ,2009,Pending,-150000,2789603,T- 71
924,Galewood/Armitage,Northwest Side,2022-07-07,Homer Street Improvements ,2009,Pending,-500000,2289603,T- 71
925,Galewood/Armitage,Northwest Side,2022-07-07,Estimated Incremental Property Tax Revenue ,2010,Committed,2424594,4714197,T- 71
926,Galewood/Armitage,Northwest Side,2022-07-07,Administrative Costs ,2010,Committed,-25000,4689197,T- 71
927,Galewood/Armitage,Northwest Side,2022-07-07,MSAC Ph.1 Debt Service 2010 - Galewood/Armitage share - Belmont Craigin ,2010,Committed,-117381,4571816,T- 71
928,Galewood/Armitage,Northwest Side,2022-07-07,Laborers' Union Initial Payment ,2010,Committed,-595837,3975979,T- 71
929,Galewood/Armitage,Northwest Side,2022-07-07,Estimated Incremental Property Tax Revenue ,2011,Committed,2424594,6400573,T- 71
930,Galewood/Armitage,Northwest Side,2022-07-07,Administrative Costs ,2011,Committed,-25000,6375573,T- 71
931,Galewood/Armitage,Northwest Side,2022-07-07,MSAC Ph.1 Debt Service 2011 - Galewood/Armitage share - Belmont Craigin ,2011,Committed,-145722,6229851,T- 71
932,Goose Island,Northwest Side,2019-07-10,FY Beginning Cash Balance ,2009,Appropriated,3257672,3257672,T- 23
933,Goose Island,Northwest Side,2019-07-10,Wrigley Innovation Center Note Payment ,2009,Appropriated,-495235,2762436,T- 23
934,Goose Island,Northwest Side,2019-07-10,Reimbursment for Cherry Street Bridge ,2009,Committed,200000,2962436,T- 23
935,Goose Island,Northwest Side,2019-07-10,Goose Island SPE I LLC Riverwall Improvement  -- 1000 N. North Branch ,2009,Committed,-132000,2830436,T- 23
936,Goose Island,Northwest Side,2019-07-10,Cherry Street Bridge ,2009,Committed,-200000,2630436,T- 23
937,Goose Island,Northwest Side,2019-07-10,TIF Works ,2009,Committed,-500000,2130436,T- 23
938,Goose Island,Northwest Side,2019-07-10,"SBIF (500 auth., 0 remaining) ",2009,Committed,-500000,1630436,T- 23
939,Goose Island,Northwest Side,2019-07-10,Seawall Improvements ,2009,Committed,-600000,1030436,T- 23
940,Goose Island,Northwest Side,2019-07-10,Watersaver Faucet ,2009,Committed,-750000,280436,T- 23
941,Goose Island,Northwest Side,2019-07-10,Estimated Incremental Property Tax Revenue ,2010,Committed,2724772,3005208,T- 23
942,Goose Island,Northwest Side,2019-07-10,Administrative Costs ,2010,Committed,-29800,2975408,T- 23
943,Goose Island,Northwest Side,2019-07-10,TIF Works ,2010,Committed,-500000,2475408,T- 23
944,Goose Island,Northwest Side,2019-07-10,Seawall Improvements ,2010,Committed,-600000,1875408,T- 23
945,Goose Island,Northwest Side,2019-07-10,Series 2000 Bond Debt Service Payment 2010  -- final payment due 2019 ,2010,Committed,-1896598,-21190,T- 23
946,Goose Island,Northwest Side,2019-07-10,SBIF ,2010,Pending,-500000,-521190,T- 23
947,Goose Island,Northwest Side,2019-07-10,Estimated Incremental Property Tax Revenue ,2011,Committed,2724772,2203581,T- 23
948,Goose Island,Northwest Side,2019-07-10,Administrative Costs ,2011,Committed,-29800,2173781,T- 23
949,Goose Island,Northwest Side,2019-07-10,TIF Works ,2011,Committed,-500000,1673781,T- 23
950,Goose Island,Northwest Side,2019-07-10,Seawall Improvements ,2011,Committed,-600000,1073781,T- 23
951,Goose Island,Northwest Side,2019-07-10,Series 2000 Bond Debt Service Payment 2011  -- final payment due 2019 ,2011,Committed,-2113860,-1040079,T- 23
952,Goose Island,Northwest Side,2019-07-10,SBIF ,2011,Pending,-500000,-1540079,T- 23
953,Greater Southwest Ind. Corrdor,Southwest Side,2023-12-31,FY Beginning Cash Balance ,2009,Appropriated,10079196,10079196,T- 66
954,Greater Southwest Ind. Corrdor,Southwest Side,2023-12-31,FY Beginning Cash Balance ,2009,Appropriated,1911300,11990496,T- 66
955,Greater Southwest Ind. Corrdor,Southwest Side,2023-12-31,PreAcquisition Account ,2009,Appropriated,-35000,11955496,T- 66
956,Greater Southwest Ind. Corrdor,Southwest Side,2023-12-31,Property Management Costs ,2009,Appropriated,-105400,11850096,T- 66
957,Greater Southwest Ind. Corrdor,Southwest Side,2023-12-31,"Gateway Park, L.L.C. Note Payment ",2009,Appropriated,-324517,11525579,T- 66
958,Greater Southwest Ind. Corrdor,Southwest Side,2023-12-31,SBIF ,2009,Appropriated,-500000,11025579,T- 66
959,Greater Southwest Ind. Corrdor,Southwest Side,2023-12-31,"Streetscape: Halsted, 39th - 42th ",2009,Appropriated,-1300000,9725579,T- 66
960,Greater Southwest Ind. Corrdor,Southwest Side,2023-12-31,Stockyards Memorial Median Kiosks ,2009,Committed,-7300,9718279,T- 66
961,Greater Southwest Ind. Corrdor,Southwest Side,2023-12-31,Pre-Acquisition ,2009,Committed,-50000,9668279,T- 66
962,Greater Southwest Ind. Corrdor,Southwest Side,2023-12-31,Professional Services ,2009,Committed,-250000,9418279,T- 66
963,Greater Southwest Ind. Corrdor,Southwest Side,2023-12-31,Vertical clearance imrprovements: 79th & Leavitt ,2009,Committed,-606200,8812079,T- 66
964,Greater Southwest Ind. Corrdor,Southwest Side,2023-12-31,Port to 47th/Halsted - Taylor Lauridsen Park ,2009,Committed,-3950064,4862015,T- 66
965,Greater Southwest Ind. Corrdor,Southwest Side,2023-12-31,Stockyards Banners ,2009,Pending,-50000,4812015,T- 66
966,Greater Southwest Ind. Corrdor,Southwest Side,2023-12-31,"Lighting - 41st-43rd St, BOE recommends 39th-43rd St.  -- 47th/Halsted TIF also ",2009,Pending,-160000,4652015,T- 66
967,Greater Southwest Ind. Corrdor,Southwest Side,2023-12-31,TIF Works ,2009,Pending,-200000,4452015,T- 66
968,Greater Southwest Ind. Corrdor,Southwest Side,2023-12-31,Small Business Improvement Fund ,2009,Pending,-250000,4202015,T- 66
969,Greater Southwest Ind. Corrdor,Southwest Side,2023-12-31,Estimated Incremental Property Tax Revenue ,2010,Committed,1913169,6115184,T- 66
970,Greater Southwest Ind. Corrdor,Southwest Side,2023-12-31,Estimated Incremental Property Tax Revenue ,2010,Committed,706247,6821431,T- 66
971,Greater Southwest Ind. Corrdor,Southwest Side,2023-12-31,"Marquette Village ""SLRDM"" & 7400 South Rockwell Drive, LLC Payment (TBD) ",2010,Committed,0,6821431,T- 66
972,Greater Southwest Ind. Corrdor,Southwest Side,2023-12-31,Administrative Costs ,2010,Committed,-14707,6806724,T- 66
973,Greater Southwest Ind. Corrdor,Southwest Side,2023-12-31,Administrative Costs ,2010,Committed,-30700,6776024,T- 66
974,Greater Southwest Ind. Corrdor,Southwest Side,2023-12-31,Professional Services - Acquisition ,2010,Committed,-100000,6676024,T- 66
975,Greater Southwest Ind. Corrdor,Southwest Side,2023-12-31,Install Corridor Signs and Banners ,2010,Committed,-100000,6576024,T- 66
976,Greater Southwest Ind. Corrdor,Southwest Side,2023-12-31,"Gateway Park, L.L.C. Note Payment ",2010,Committed,-311198,6264825,T- 66
977,Greater Southwest Ind. Corrdor,Southwest Side,2023-12-31,4150 S. Halsted Engineering Report ,2010,Pending,-50000,6214825,T- 66
978,Greater Southwest Ind. Corrdor,Southwest Side,2023-12-31,TIF Works ,2010,Pending,-500000,5714825,T- 66
979,Greater Southwest Ind. Corrdor,Southwest Side,2023-12-31,Estimated Incremental Property Tax Revenue ,2011,Committed,1913169,7627994,T- 66
980,Greater Southwest Ind. Corrdor,Southwest Side,2023-12-31,Estimated Incremental Property Tax Revenue ,2011,Committed,706247,8334241,T- 66
981,Greater Southwest Ind. Corrdor,Southwest Side,2023-12-31,"Marquette Village ""SLRDM"" & 7400 South Rockwell Drive, LLC Payment (TBD) ",2011,Committed,0,8334241,T- 66
982,Greater Southwest Ind. Corrdor,Southwest Side,2023-12-31,Administrative Costs ,2011,Committed,-14707,8319534,T- 66
983,Greater Southwest Ind. Corrdor,Southwest Side,2023-12-31,Administrative Costs ,2011,Committed,-30700,8288834,T- 66
984,Greater Southwest Ind. Corrdor,Southwest Side,2023-12-31,FY Beginning Cash Balance ,2009,Appropriated,6534515,6534515,T- 66
985,Greater Southwest Ind. Corrdor,Southwest Side,2023-12-31,Median Planter - Cicero and 72nd Intersection ,2009,Committed,-300000,6234515,T- 66
986,Greater Southwest Ind. Corrdor,Southwest Side,2023-12-31,Port to 67th/Cicero - Madigan Fields ,2009,Committed,-2824023,3410492,T- 66
987,Greater Southwest Ind. Corrdor,Southwest Side,2023-12-31,TIF Works ,2009,Pending,-100000,3310492,T- 66
988,Greater Southwest Ind. Corrdor,Southwest Side,2023-12-31,Estimated Incremental Property Tax Revenue ,2010,Committed,1549083,4859575,T- 66
989,Greater Southwest Ind. Corrdor,Southwest Side,2023-12-31,Administrative Costs ,2010,Committed,-22066,4837509,T- 66
990,Greater Southwest Ind. Corrdor,Southwest Side,2023-12-31,Pre-Acquisition ,2010,Committed,-100000,4737509,T- 66
991,Greater Southwest Ind. Corrdor,Southwest Side,2023-12-31,"SBIF (1M auth., 500k remaining) ",2010,Committed,-500000,4237509,T- 66
992,Greater Southwest Ind. Corrdor,Southwest Side,2023-12-31,Acquisition - 7301 S. Kostner ,2010,Committed,-1500000,2737509,T- 66
993,Greater Southwest Ind. Corrdor,Southwest Side,2023-12-31,Estimated Incremental Property Tax Revenue ,2011,Committed,1549083,4286592,T- 66
994,Greater Southwest Ind. Corrdor,Southwest Side,2023-12-31,Administrative Costs ,2011,Committed,-22066,4264526,T- 66
995,Greater Southwest Ind. Corrdor,Southwest Side,2023-12-31,Engineering Study Street Dedication 73rd/Kostner-Tripp ,2011,Committed,-200000,4064526,T- 66
996,Greater Southwest Ind. Corrdor,Southwest Side,2023-12-31,Street Construction  -- Street Dedication 73rd/Kostner-Tripp ,2011,Committed,-4000000,64526,T- 66
997,Harlem Industrial Park Conservation Area,Southwest Side,2030-03-14,FY Beginning Cash Balance ,2009,Appropriated,244149,244149,T-148
998,Harlem Industrial Park Conservation Area,Southwest Side,2030-03-14,Administration Costs ,2009,Committed,0,244149,T-148
999,Harlem Industrial Park Conservation Area,Southwest Side,2030-03-14,North & Talman Residential Dev. RDA payment 2009 ,2009,Committed,-351588,-107439,T-148
1000,Harlem Industrial Park Conservation Area,Southwest Side,2030-03-14,"SBIF (500k auth., 0 remaining) ",2009,Committed,-500000,-607439,T-148
1001,Harlem Industrial Park Conservation Area,Southwest Side,2030-03-14,Estimated Incremental Property Tax Revenue ,2010,Committed,244000,-363439,T-148
1002,Harlem Industrial Park Conservation Area,Southwest Side,2030-03-14,Administration Costs ,2010,Committed,0,-363439,T-148
1003,Harlem Industrial Park Conservation Area,Southwest Side,2030-03-14,Estimated Incremental Property Tax Revenue ,2011,Committed,244000,-119439,T-148
1004,Harlem Industrial Park Conservation Area,Southwest Side,2030-03-14,Administration Costs ,2011,Committed,0,-119439,T-148
1005,Harrison/Central,West Side,2030-12-31,FY Beginning Cash Balance ,2009,Appropriated,1305312,1305312,T-144
1006,Harrison/Central,West Side,2030-12-31,Closing payment to Loretto Hospital  -- 2009 ,2009,Appropriated,-500000,805312,T-144
1007,Harrison/Central,West Side,2030-12-31,Port from Madison/Austin for 2009 Loretto Hospital room payment ,2009,Committed,375000,1180312,T-144
1008,Harrison/Central,West Side,2030-12-31,Port from Roosevelt/Cicero for 2009 Loretto Hospital room payment ,2009,Committed,375000,1555312,T-144
1009,Harrison/Central,West Side,2030-12-31,Administrative Costs ,2009,Committed,0,1555312,T-144
1010,Harrison/Central,West Side,2030-12-31,NIF Note Payment 2009 ,2009,Committed,-96000,1459312,T-144
1011,Harrison/Central,West Side,2030-12-31,"Lighting: W. Congress St., VanBuren to Adams, Laramie to Lotus ",2009,Committed,-585000,874312,T-144
1012,Harrison/Central,West Side,2030-12-31,Neighborhood Imprv. Prgm. ,2009,Committed,-750000,124312,T-144
1013,Harrison/Central,West Side,2030-12-31,2009 Room Payment to Loretto Hospital ,2009,Committed,-800000,-675688,T-144
1014,Harrison/Central,West Side,2030-12-31,Port from Madison/Austin for 2010 Loretto Hospital room payment ,2010,Committed,375000,-300688,T-144
1015,Harrison/Central,West Side,2030-12-31,Port from Roosevelt/Cicero for 2010 Loretto Hospital room payment ,2010,Committed,375000,74312,T-144
1016,Harrison/Central,West Side,2030-12-31,Estimated Incremental Property Tax Revenue ,2010,Committed,228000,302312,T-144
1017,Harrison/Central,West Side,2030-12-31,Administrative Costs ,2010,Committed,0,302312,T-144
1018,Harrison/Central,West Side,2030-12-31,NIF Note Payment 2010 ,2010,Committed,-194700,107612,T-144
1019,Harrison/Central,West Side,2030-12-31,2010 Room Payment to Loretto Hospital ,2010,Committed,-800000,-692388,T-144
1020,Harrison/Central,West Side,2030-12-31,Port from Roosevelt/Cicero for 2011 Loretto Hospital room payment ,2011,Committed,375000,-317388,T-144
1021,Harrison/Central,West Side,2030-12-31,Port from Madison/Austin for 2011 Loretto Hospital room payment ,2011,Committed,375000,57612,T-144
1022,Harrison/Central,West Side,2030-12-31,Estimated Incremental Property Tax Revenue ,2011,Committed,228000,285612,T-144
1023,Harrison/Central,West Side,2030-12-31,NIF Note Payment 2011 ,2011,Committed,-194800,90812,T-144
1024,Harrison/Central,West Side,2030-12-31,2011 Room Payment to Loretto Hospital ,2011,Committed,-800000,-709188,T-144
1025,Hollywood/Sheridan,North Side,2031-12-31,Port from Lawrence/Broadway for Hollywood House payment ,2009,Appropriated,1000000,1000000,T-157
1026,Hollywood/Sheridan,North Side,2031-12-31,Port from Bryn/Mawr Broadway for SBIF ,2009,Appropriated,250000,1250000,T-157
1027,Hollywood/Sheridan,North Side,2031-12-31,FY Beginning Cash Balance ,2009,Appropriated,167478,1417478,T-157
1028,Hollywood/Sheridan,North Side,2031-12-31,"SBIF (400k auth., 150K auth. remaining) ",2009,Appropriated,-250000,1167478,T-157
1029,Hollywood/Sheridan,North Side,2031-12-31,Hollywood House cash payment ,2009,Appropriated,-1000000,167478,T-157
1030,Hollywood/Sheridan,North Side,2031-12-31,Port from Bryn Mawr / Broadway  -- Edgewater library acquistion ,2009,Committed,1125000,1292478,T-157
1031,Hollywood/Sheridan,North Side,2031-12-31,Administration ,2009,Committed,0,1292478,T-157
1032,Hollywood/Sheridan,North Side,2031-12-31,"Streetscaping- Granville, Broadway to Sheridan; design ",2009,Pending,-225000,1067478,T-157
1033,Hollywood/Sheridan,North Side,2031-12-31,Potential Redevelopment Project ,2009,Pending,-1125000,-57522,T-157
1034,Hollywood/Sheridan,North Side,2031-12-31,Estimated Incremental Property Tax Revenue ,2010,Committed,167400,109878,T-157
1035,Hollywood/Sheridan,North Side,2031-12-31,Administration ,2010,Committed,0,109878,T-157
1036,Hollywood/Sheridan,North Side,2031-12-31,"Streetscaping- Granville, Broadway to Sheridan; construction ",2010,Pending,-1875000,-1765122,T-157
1037,Hollywood/Sheridan,North Side,2031-12-31,Estimated Incremental Property Tax Revenue ,2011,Committed,167400,-1597722,T-157
1038,Hollywood/Sheridan,North Side,2031-12-31,Administration ,2011,Committed,0,-1597722,T-157
1039,Homan Arthington,Northwest Side,2021-02-05,FY Beginning Cash Balance ,2009,Appropriated,3493999,3493999,T- 24
1040,Homan Arthington,Northwest Side,2021-02-05,Professional Services Account Increase ,2009,Appropriated,-50000,3443999,T- 24
1041,Homan Arthington,Northwest Side,2021-02-05,"Street resurfacing: Arthington, Kedzie to Spaulding ",2009,Appropriated,-102622,3341376,T- 24
1042,Homan Arthington,Northwest Side,2021-02-05,Street Resurfacing & ADA ramps ,2009,Appropriated,-395905,2945471,T- 24
1043,Homan Arthington,Northwest Side,2021-02-05,Homan Square Police Forensics Lab Improvements  -- 2240 W. Filmore St. ,2009,Appropriated,-1500000,1445471,T- 24
1044,Homan Arthington,Northwest Side,2021-02-05,Port to Midwest for street resurfacing ,2009,Committed,-1000000,445471,T- 24
1045,Homan Arthington,Northwest Side,2021-02-05,Disposition Services ,2009,Pending,-200000,245471,T- 24
1046,Homan Arthington,Northwest Side,2021-02-05,Estimated Incremental Property Tax Revenue ,2010,Committed,489809,735280,T- 24
1047,Homan Arthington,Northwest Side,2021-02-05,Administrative Costs ,2010,Committed,-10400,724880,T- 24
1048,Homan Arthington,Northwest Side,2021-02-05,Estimated Incremental Property Tax Revenue ,2011,Committed,489809,1214689,T- 24
1049,Homan Arthington,Northwest Side,2021-02-05,Administrative Costs ,2011,Committed,-10400,1204289,T- 24
1050,Homan/Grand Trunk,South Side,2016-12-15,FY Beginning Cash Balance ,2009,Appropriated,2006029,2006029,T- 25
1051,Homan/Grand Trunk,South Side,2016-12-15,Portability Amendment ,2009,Committed,-50000,1956029,T- 25
1052,Homan/Grand Trunk,South Side,2016-12-15,Estimated Incremental Property Tax Revenue ,2010,Committed,184476,2140505,T- 25
1053,Homan/Grand Trunk,South Side,2016-12-15,Administrative Costs ,2010,Committed,-3500,2137005,T- 25
1054,Homan/Grand Trunk,South Side,2016-12-15,Estimated Incremental Property Tax Revenue ,2011,Committed,184476,2321481,T- 25
1055,Homan/Grand Trunk,South Side,2016-12-15,Administrative Costs ,2011,Committed,-3500,2317981,T- 25
1056,Howard/Paulina,North Side,2011-10-14,FY Beginning Cash Balance ,2009,Appropriated,3182159,3182159,T- 26
1057,Howard/Paulina,North Side,2011-10-14,"Streetscape: Howard St  -- phase I, GO reimbursement ",2009,Appropriated,-493769,2688390,T- 26
1058,Howard/Paulina,North Side,2011-10-14,Gale Community Center Park  -- GO Reimbursement ,2009,Appropriated,-2156231,532159,T- 26
1059,Howard/Paulina,North Side,2011-10-14,Estimated Incremental Property Tax Revenue ,2010,Committed,1673759,2205917,T- 26
1060,Howard/Paulina,North Side,2011-10-14,Administrative Costs ,2010,Committed,-41088,2164829,T- 26
1061,Howard/Paulina,North Side,2011-10-14,Gale School Campus Park Community Building ,2010,Committed,-800000,1364829,T- 26
1062,Howard/Paulina,North Side,2011-10-14,"Streetscape: Howard St  -- phase II, CTA station to Ashland; construction ",2010,Committed,-1600000,-235171,T- 26
1063,Howard/Paulina,North Side,2011-10-14,Estimated Incremental Property Tax Revenue ,2011,Committed,1673759,1438588,T- 26
1064,Howard/Paulina,North Side,2011-10-14,Administrative Costs ,2011,Committed,-41088,1397500,T- 26
1065,Humboldt Park,Northwest Side,2025-12-31,FY Beginning Cash Balance ,2009,Appropriated,3593594,3593594,T-108
1066,Humboldt Park,Northwest Side,2025-12-31,LaEstancia RDA 2009 Payment ,2009,Appropriated,-201371,3392223,T-108
1067,Humboldt Park,Northwest Side,2025-12-31,Payoff of Outstanding Bank Note Balance ,2009,Committed,-573355,2818868,T-108
1068,Humboldt Park,Northwest Side,2025-12-31,New Life Foundation ,2009,Pending,-204000,2614868,T-108
1069,Humboldt Park,Northwest Side,2025-12-31,Broadband Initiative ,2009,Pending,-1040749,1574120,T-108
1070,Humboldt Park,Northwest Side,2025-12-31,Estimated Incremental Property Tax Revenue ,2010,Committed,2279464,3853584,T-108
1071,Humboldt Park,Northwest Side,2025-12-31,Administrative Costs ,2010,Committed,-38900,3814684,T-108
1072,Humboldt Park,Northwest Side,2025-12-31,TIF Works ,2010,Committed,-100000,3714684,T-108
1073,Humboldt Park,Northwest Side,2025-12-31,North & Talman Residential Dev. RDA payment 2010 ,2010,Committed,-351588,3363096,T-108
1074,Humboldt Park,Northwest Side,2025-12-31,SBIF: 1M authorized less current release amt = 500k remaining ,2010,Committed,-500000,2863096,T-108
1075,Humboldt Park,Northwest Side,2025-12-31,New Life Foundation ,2010,Pending,-204000,2659096,T-108
1076,Humboldt Park,Northwest Side,2025-12-31,"Neigh. Impr. Prgm. (1M auth., 500k remaining) ",2010,Pending,-500000,2159096,T-108
1077,Humboldt Park,Northwest Side,2025-12-31,Estimated Incremental Property Tax Revenue ,2011,Committed,2279464,4438559,T-108
1078,Humboldt Park,Northwest Side,2025-12-31,2425 W. North Ave Acquisition reimburse from Open Space Impact Fees ,2011,Committed,250000,4688559,T-108
1079,Humboldt Park,Northwest Side,2025-12-31,Administrative Costs ,2011,Committed,-38900,4649659,T-108
1080,Humboldt Park,Northwest Side,2025-12-31,North & Talman Residential Dev. RDA payment 2011 ,2011,Committed,-351588,4298071,T-108
1081,Humboldt Park,Northwest Side,2025-12-31,New Life Foundation ,2011,Pending,-204000,4094071,T-108
1082,Irving/Cicero,Northwest Side,2020-12-31,FY Beginning Cash Balance ,2009,Appropriated,448882,448882,T- 27
1083,Irving/Cicero,Northwest Side,2020-12-31,Pre-acquisition account increase ,2009,Appropriated,-50000,398882,T- 27
1084,Irving/Cicero,Northwest Side,2020-12-31,Klee Building RDA Certificate of Completion payment ,2009,Committed,-506093,-107211,T- 27
1085,Irving/Cicero,Northwest Side,2020-12-31,Estimated Incremental Property Tax Revenue ,2010,Committed,580701,473490,T- 27
1086,Irving/Cicero,Northwest Side,2020-12-31,Administrative Costs ,2010,Committed,-12365,461125,T- 27
1087,Irving/Cicero,Northwest Side,2020-12-31,Klee RDA note payment  -- est ,2010,Committed,-79000,382125,T- 27
1088,Irving/Cicero,Northwest Side,2020-12-31,Series 1998 Bond Debt Service 2010  -- last payment due in 2014 ,2010,Committed,-530900,-148775,T- 27
1089,Irving/Cicero,Northwest Side,2020-12-31,Estimated Incremental Property Tax Revenue ,2011,Committed,580701,431927,T- 27
1090,Irving/Cicero,Northwest Side,2020-12-31,Administrative Costs ,2011,Committed,-12365,419562,T- 27
1091,Irving/Cicero,Northwest Side,2020-12-31,Klee RDA note payment  -- est ,2011,Committed,-85200,334362,T- 27
1092,Irving/Cicero,Northwest Side,2020-12-31,Series 1998 Bond Debt Service 2011 -- last payment due in 2014 ,2011,Committed,-598350,-263988,T- 27
1093,Jefferson/Roosevelt,Central,2024-12-31,FY Beginning Cash Balance ,2009,Appropriated,5108839,5108839,T-101
1094,Jefferson/Roosevelt,Central,2024-12-31,Central Business District Underground Mapping Intiative Phase 3 ,2009,Appropriated,-173546,4935293,T-101
1095,Jefferson/Roosevelt,Central,2024-12-31,Maxwell Street Market - Appraisals ,2009,Committed,-25000,4910293,T-101
1096,Jefferson/Roosevelt,Central,2024-12-31,Maxwell St. Market: add'l ,2009,Committed,-120000,4790293,T-101
1097,Jefferson/Roosevelt,Central,2024-12-31,Estimated Incremental Property Tax Revenue ,2010,Committed,3502062,8292354,T-101
1098,Jefferson/Roosevelt,Central,2024-12-31,Administrative Costs ,2010,Committed,-32000,8260354,T-101
1099,Jefferson/Roosevelt,Central,2024-12-31,Estimated Incremental Property Tax Revenue ,2011,Committed,3502062,11762416,T-101
1100,Jefferson/Roosevelt,Central,2024-12-31,Administrative Costs ,2011,Committed,-32000,11730416,T-101
1101,Jefferson/Roosevelt,Central,2024-12-31,FY Beginning Cash Balance ,2009,Appropriated,1528162,1528162,T-101
1102,Jefferson/Roosevelt,Central,2024-12-31,Demo reimbursement  -- 4935 N Central ,2009,Appropriated,-9000,1519162,T-101
1103,Jefferson/Roosevelt,Central,2024-12-31,"Match to Federal Funds: Milwaukee, Montrose to Gale ",2009,Appropriated,-300000,1219162,T-101
1104,Jefferson/Roosevelt,Central,2024-12-31,Env. Remediation phase II pocket park ,2009,Committed,-50000,1169162,T-101
1105,Jefferson/Roosevelt,Central,2024-12-31,Jefferson Park playground ,2009,Committed,-500000,669162,T-101
1106,Jefferson/Roosevelt,Central,2024-12-31,Estimated Incremental Property Tax Revenue ,2010,Committed,868000,1537162,T-101
1107,Jefferson/Roosevelt,Central,2024-12-31,Administrative Costs ,2010,Committed,-15600,1521562,T-101
1108,Jefferson/Roosevelt,Central,2024-12-31,Gateway Sign ,2010,Pending,-100000,1421562,T-101
1109,Jefferson/Roosevelt,Central,2024-12-31,Estimated Incremental Property Tax Revenue ,2011,Committed,868000,2289562,T-101
1110,Jefferson/Roosevelt,Central,2024-12-31,Administrative Costs ,2011,Committed,-15600,2273962,T-101
1111,Kimball/Kennedy,Northwest Side,2032-12-31,FY Beginning Cash Balance ,2009,Appropriated,0,0,T-160
1112,Kimball/Kennedy,Northwest Side,2032-12-31,Adminstration ,2009,Committed,0,0,T-160
1113,Kimball/Kennedy,Northwest Side,2032-12-31,Estimated Incremental Property Tax Revenue ,2010,Committed,0,0,T-160
1114,Kimball/Kennedy,Northwest Side,2032-12-31,Estimated Incremental Property Tax Revenue ,2011,Committed,0,0,T-160
1115,Kinzie Industrial Corridor,Northwest Side,2021-06-10,FY Beginning Cash Balance ,2009,Appropriated,36259279,36259279,T- 52
1116,Kinzie Industrial Corridor,Northwest Side,2021-06-10,Central Business District Underground Mapping Intiative Phase 3 ,2009,Appropriated,-14515,36244763,T- 52
1117,Kinzie Industrial Corridor,Northwest Side,2021-06-10,Demolition account increase ,2009,Appropriated,-30734,36214029,T- 52
1118,Kinzie Industrial Corridor,Northwest Side,2021-06-10,Pre-acquisition account increase ,2009,Appropriated,-35000,36179029,T- 52
1119,Kinzie Industrial Corridor,Northwest Side,2021-06-10,"Street reconstruction: Kinzie St, Ogden to DesPlaines - Design  -- add'l ",2009,Appropriated,-72345,36106684,T- 52
1120,Kinzie Industrial Corridor,Northwest Side,2021-06-10,Harold Washington Unity Coop  -- DOH payment ,2009,Appropriated,-88128,36018556,T- 52
1121,Kinzie Industrial Corridor,Northwest Side,2021-06-10,MOWD 2009 Budget ,2009,Appropriated,-190000,35828556,T- 52
1122,Kinzie Industrial Corridor,Northwest Side,2021-06-10,"Railroad Crossing Removal  -- May, Morgan, Racine ",2009,Appropriated,-220680,35607876,T- 52
1123,Kinzie Industrial Corridor,Northwest Side,2021-06-10,TIF Works 2009 ,2009,Appropriated,-300000,35307876,T- 52
1124,Kinzie Industrial Corridor,Northwest Side,2021-06-10,2009 Industrial Street Improvements ,2009,Appropriated,-587000,34720876,T- 52
1125,Kinzie Industrial Corridor,Northwest Side,2021-06-10,27th Ward Infrastructure: Green Alley program ,2009,Appropriated,-733900,33986976,T- 52
1126,Kinzie Industrial Corridor,Northwest Side,2021-06-10,SBIF ,2009,Appropriated,-1000000,32986976,T- 52
1127,Kinzie Industrial Corridor,Northwest Side,2021-06-10,Coyne American Inst. RDA payment ,2009,Appropriated,-1192647,31794329,T- 52
1128,Kinzie Industrial Corridor,Northwest Side,2021-06-10,Greater Westtown RDA  -- 1 of 3 ,2009,Appropriated,-1314982,30479347,T- 52
1129,Kinzie Industrial Corridor,Northwest Side,2021-06-10,CTA Green Line Station @ Morgan  -- construction ,2009,Appropriated,-27800000,2679347,T- 52
1130,Kinzie Industrial Corridor,Northwest Side,2021-06-10,Curb and Sidewalk ,2009,Committed,-123331,2556016,T- 52
1131,Kinzie Industrial Corridor,Northwest Side,2021-06-10,"Lake/Halsted to Kedzie Streetscaping, Phase I-Engineering Only ",2009,Committed,-500000,2056016,T- 52
1132,Kinzie Industrial Corridor,Northwest Side,2021-06-10,Smith Park ,2009,Committed,-512000,1544016,T- 52
1133,Kinzie Industrial Corridor,Northwest Side,2021-06-10,"Parking and Streetscape Phase I, Lake - Halsted - Kedzie ",2009,Committed,-1000000,544016,T- 52
1134,Kinzie Industrial Corridor,Northwest Side,2021-06-10,"CPS ADA projects  -- Beidler, Morton ",2009,Committed,-1500000,-955984,T- 52
1135,Kinzie Industrial Corridor,Northwest Side,2021-06-10,27th Ward Infrastructure: multiple locations  -- 2009 ,2009,Committed,-2249257,-3205240,T- 52
1136,Kinzie Industrial Corridor,Northwest Side,2021-06-10,Streetscaping 2nd ward locations TBD ,2009,Pending,-117000,-3322240,T- 52
1137,Kinzie Industrial Corridor,Northwest Side,2021-06-10,Broadband Initiative ,2009,Pending,-397151,-3719391,T- 52
1138,Kinzie Industrial Corridor,Northwest Side,2021-06-10,Estimated Incremental Property Tax Revenue ,2010,Committed,14498548,10779157,T- 52
1139,Kinzie Industrial Corridor,Northwest Side,2021-06-10,Administrative Costs ,2010,Committed,-251200,10527957,T- 52
1140,Kinzie Industrial Corridor,Northwest Side,2021-06-10,Coyne Inst. RDA payment  -- est ,2010,Committed,-500000,10027957,T- 52
1141,Kinzie Industrial Corridor,Northwest Side,2021-06-10,SBIF ,2010,Committed,-1000000,9027957,T- 52
1142,Kinzie Industrial Corridor,Northwest Side,2021-06-10,Greater Westtown RDA  -- 2 of 3 ,2010,Committed,-1050000,7977957,T- 52
1143,Kinzie Industrial Corridor,Northwest Side,2021-06-10,MSAC Ph.1 DS 2010 - Westinghouse  -- Chicago / Central park ,2010,Committed,-3058845,4919112,T- 52
1144,Kinzie Industrial Corridor,Northwest Side,2021-06-10,"Parking and Streetscape Phase II, Lake - Halsted - Kedzie ",2010,Committed,-3500000,1419112,T- 52
1145,Kinzie Industrial Corridor,Northwest Side,2021-06-10,27th Ward Infrastructure: multiple locations  -- 2010 ,2010,Committed,-5459000,-4039888,T- 52
1146,Kinzie Industrial Corridor,Northwest Side,2021-06-10,CB2 Note 2 payment ,2010,Pending,-150000,-4189888,T- 52
1147,Kinzie Industrial Corridor,Northwest Side,2021-06-10,CB2 Note 1 payment ,2010,Pending,-250000,-4439888,T- 52
1148,Kinzie Industrial Corridor,Northwest Side,2021-06-10,TIF Works ,2010,Pending,-300000,-4739888,T- 52
1149,Kinzie Industrial Corridor,Northwest Side,2021-06-10,Estimated Incremental Property Tax Revenue ,2011,Committed,14498548,9758660,T- 52
1150,Kinzie Industrial Corridor,Northwest Side,2021-06-10,Administrative Costs ,2011,Committed,-251200,9507460,T- 52
1151,Kinzie Industrial Corridor,Northwest Side,2021-06-10,Coyne Inst. RDA payment  -- est ,2011,Committed,-500000,9007460,T- 52
1152,Kinzie Industrial Corridor,Northwest Side,2021-06-10,Beidler campus park ,2011,Committed,-1000000,8007460,T- 52
1153,Kinzie Industrial Corridor,Northwest Side,2021-06-10,Greater Westtown RDA  -- 3 of 3 ,2011,Committed,-1050000,6957460,T- 52
1154,Kinzie Industrial Corridor,Northwest Side,2021-06-10,MSAC Ph.1 DS 2011 - Westinghouse  -- Chicago / Central park ,2011,Committed,-2974054,3983406,T- 52
1155,Kinzie Industrial Corridor,Northwest Side,2021-06-10,PBC - Library  -- West Humboldt Park - construction  -- 1 of 2 ,2011,Committed,-5000000,-1016594,T- 52
1156,Kinzie Industrial Corridor,Northwest Side,2021-06-10,27th Ward Infrastructure: multiple locations  -- 2011 ,2011,Committed,-5463700,-6480294,T- 52
1157,Kinzie Industrial Corridor,Northwest Side,2021-06-10,CB2 Note 2 payment ,2011,Pending,-150000,-6630294,T- 52
1158,Kinzie Industrial Corridor,Northwest Side,2021-06-10,CB2 Note 1 payment ,2011,Pending,-250000,-6880294,T- 52
1159,Lake Calumet Ind. Cord.,South Side,2024-12-31,FY Beginning Cash Balance ,2009,Appropriated,11097606,11097606,T-103
1160,Lake Calumet Ind. Cord.,South Side,2024-12-31,Pre-acquisition account increase ,2009,Appropriated,-25000,11072606,T-103
1161,Lake Calumet Ind. Cord.,South Side,2024-12-31,Avenue O Phase 1  -- add'l ,2009,Appropriated,-1171712,9900894,T-103
1162,Lake Calumet Ind. Cord.,South Side,2024-12-31,Avenue O Phase II: 118th to 123rd ,2009,Appropriated,-3168306,6732588,T-103
1163,Lake Calumet Ind. Cord.,South Side,2024-12-31,Bridge work @ Torrence Ave. & Calumet River ,2009,Appropriated,-4000000,2732588,T-103
1164,Lake Calumet Ind. Cord.,South Side,2024-12-31,111th Doty - Study: Reconfigure traffic for retail/residential ,2009,Committed,-820000,1912588,T-103
1165,Lake Calumet Ind. Cord.,South Side,2024-12-31,Torrence Ave. sidwalk bike path improvements ,2009,Committed,-1000000,912588,T-103
1166,Lake Calumet Ind. Cord.,South Side,2024-12-31,Broadband Initiative ,2009,Pending,-269966,642622,T-103
1167,Lake Calumet Ind. Cord.,South Side,2024-12-31,Estimated Incremental Property Tax Revenue ,2010,Committed,5766577,6409199,T-103
1168,Lake Calumet Ind. Cord.,South Side,2024-12-31,Administrative Costs ,2010,Committed,-87400,6321799,T-103
1169,Lake Calumet Ind. Cord.,South Side,2024-12-31,Brainard Ave. Resurfacing; 2734 East to State Line ,2010,Pending,-2000000,4321799,T-103
1170,Lake Calumet Ind. Cord.,South Side,2024-12-31,Estimated Incremental Property Tax Revenue ,2011,Committed,5766577,10088376,T-103
1171,Lake Calumet Ind. Cord.,South Side,2024-12-31,Administrative Costs ,2011,Committed,-87400,10000976,T-103
1172,Lakefront,South Side,2026-12-31,FY Beginning Cash Balance ,2009,Appropriated,294845,294845,T-119
1173,Lakefront,South Side,2026-12-31,Lake Park Crescent II ,2009,Appropriated,-51620,243225,T-119
1174,Lakefront,South Side,2026-12-31,Estimated Incremental Property Tax Revenue ,2010,Committed,90475,333699,T-119
1175,Lakefront,South Side,2026-12-31,Lake Park Crescent II ,2010,Committed,0,333699,T-119
1176,Lakefront,South Side,2026-12-31,Administrative Costs ,2010,Committed,-6900,326799,T-119
1177,Lakefront,South Side,2026-12-31,Estimated Incremental Property Tax Revenue ,2011,Committed,90475,417274,T-119
1178,Lakefront,South Side,2026-12-31,Lake Park Crescent II ,2011,Committed,0,417274,T-119
1179,Lakefront,South Side,2026-12-31,Administrative Costs ,2011,Committed,-6900,410374,T-119
1180,Lakeside/Clarendon,North Side,2028-12-31,FY Beginning Cash Balance ,2009,Appropriated,87186,87186,T-137
1181,Lakeside/Clarendon,North Side,2028-12-31,Estimated Incremental Property Tax Revenue ,2010,Committed,56531,143717,T-137
1182,Lakeside/Clarendon,North Side,2028-12-31,Administrative Costs ,2010,Committed,-1750,141967,T-137
1183,Lakeside/Clarendon,North Side,2028-12-31,Estimated Incremental Property Tax Revenue ,2011,Committed,56531,198498,T-137
1184,Lakeside/Clarendon,North Side,2028-12-31,Administrative Costs ,2011,Committed,-1750,196748,T-137
1185,LaSalle Central,Central,2030-12-31,FY Beginning Cash Balance ,2009,Appropriated,27283723,27283723,T-147
1186,LaSalle Central,Central,2030-12-31,Professional Services Account Increase ,2009,Appropriated,-50000,27233723,T-147
1187,LaSalle Central,Central,2030-12-31,Central Business District Underground Mapping Intiative Phase 3 ,2009,Appropriated,-51980,27181744,T-147
1188,LaSalle Central,Central,2030-12-31,"Viaduct reconstruction: Wacker, Adams to Congress ",2009,Appropriated,-213000,26968744,T-147
1189,LaSalle Central,Central,2030-12-31,Ziegler HQ relocation RDA  -- 2 of 10 ,2009,Appropriated,-214600,26754144,T-147
1190,LaSalle Central,Central,2030-12-31,"Viaduct reconstruction: Wacker, Randolph to Adams ",2009,Appropriated,-260000,26494144,T-147
1191,LaSalle Central,Central,2030-12-31,Median & Sidewalks: Wacker Drive  -- eng. ,2009,Appropriated,-300000,26194144,T-147
1192,LaSalle Central,Central,2030-12-31,Sidewalk ramp repair ,2009,Appropriated,-400000,25794144,T-147
1193,LaSalle Central,Central,2030-12-31,Sidewalks and ramps  -- ADA: Wacker Drive ,2009,Appropriated,-500000,25294144,T-147
1194,LaSalle Central,Central,2030-12-31,Sidewalks and ramps  -- ADA: Wacker Drive ,2009,Appropriated,-2150000,23144144,T-147
1195,LaSalle Central,Central,2030-12-31,"Wacker Drive Reconstruction, Randolph to VanBuren ",2009,Appropriated,-3000000,20144144,T-147
1196,LaSalle Central,Central,2030-12-31,Audible Pedestrian Signals ,2009,Committed,-8000,20136144,T-147
1197,LaSalle Central,Central,2030-12-31,Lyric Opera ,2009,Committed,-500000,19636144,T-147
1198,LaSalle Central,Central,2030-12-31,Willis Group RDA ,2009,Committed,-1000000,18636144,T-147
1199,LaSalle Central,Central,2030-12-31,MillerCoors RDA completion payment  -- 1 of 6 ,2009,Committed,-1000000,17636144,T-147
1200,LaSalle Central,Central,2030-12-31,Estimated Incremental Property Tax Revenue ,2010,Committed,18000000,35636144,T-147
1201,LaSalle Central,Central,2030-12-31,Ziegler HQ relocation RDA  -- 3 of 10 ,2010,Committed,-241600,35394544,T-147
1202,LaSalle Central,Central,2030-12-31,Administrative Costs ,2010,Committed,-340000,35054544,T-147
1203,LaSalle Central,Central,2030-12-31,Willis Group RDA ,2010,Committed,-825000,34229544,T-147
1204,LaSalle Central,Central,2030-12-31,MillerCoors RDA annual payment  -- 2 of 6 ,2010,Committed,-955000,33274544,T-147
1205,LaSalle Central,Central,2030-12-31,NAVTEQ RDA payment  -- 1 of 5 ,2010,Committed,-1500000,31774544,T-147
1206,LaSalle Central,Central,2030-12-31,UAL Ops HQ Phase 1 Completion Payment ,2010,Committed,-3000000,28774544,T-147
1207,LaSalle Central,Central,2030-12-31,Potential Redevelopment Project ,2010,Pending,-2000000,26774544,T-147
1208,LaSalle Central,Central,2030-12-31,Potential Redevelopment Project ,2010,Pending,-3500000,23274544,T-147
1209,LaSalle Central,Central,2030-12-31,Potential Redevelopment Project ,2010,Pending,-15000000,8274544,T-147
1210,LaSalle Central,Central,2030-12-31,Potential Redevelopment Project ,2010,Pending,-20000000,-11725456,T-147
1211,LaSalle Central,Central,2030-12-31,Estimated Incremental Property Tax Revenue ,2011,Committed,18000000,6274544,T-147
1212,LaSalle Central,Central,2030-12-31,Ziegler HQ relocation RDA  -- 4 of 10 ,2011,Committed,-241600,6032944,T-147
1213,LaSalle Central,Central,2030-12-31,Administrative Costs ,2011,Committed,-340000,5692944,T-147
1214,LaSalle Central,Central,2030-12-31,Willis Group RDA ,2011,Committed,-825000,4867944,T-147
1215,LaSalle Central,Central,2030-12-31,MillerCoors RDA annual payment  -- 3 of 6 ,2011,Committed,-955000,3912944,T-147
1216,LaSalle Central,Central,2030-12-31,UAL Ops HQ RDA Job Training ,2011,Committed,-1500000,2412944,T-147
1217,LaSalle Central,Central,2030-12-31,NAVTEQ RDA payment  -- 2 of 5 ,2011,Committed,-1500000,912944,T-147
1218,LaSalle Central,Central,2030-12-31,UAL Ops HQ Phase 2 Completion Payment ,2011,Committed,-3000000,-2087056,T-147
1219,LaSalle Central,Central,2030-12-31,UAL Ops HQ RDA annual payment  -- 1 of 8 ,2011,Committed,-3200091,-5287147,T-147
1220,LaSalle Central,Central,2030-12-31,Potential Redevelopment Project ,2011,Pending,-1300000,-6587147,T-147
1221,LaSalle Central,Central,2030-12-31,Potential Redevelopment Project ,2011,Pending,-13000000,-19587147,T-147
1222,Lawrence/Broadway,North Side,2025-12-31,FY Beginning Cash Balance ,2009,Appropriated,4398199,4398199,T-109
1223,Lawrence/Broadway,North Side,2025-12-31,"ADA ramps: Lawrence, Magnolia to Broadway ",2009,Appropriated,-21700,4376499,T-109
1224,Lawrence/Broadway,North Side,2025-12-31,ADA ramps: Racine/Leland ,2009,Appropriated,-54000,4322499,T-109
1225,Lawrence/Broadway,North Side,2025-12-31,"ADA ramps: Broadway, Ainslie to Leland ",2009,Appropriated,-62000,4260499,T-109
1226,Lawrence/Broadway,North Side,2025-12-31,Gunnison Lofts Note Payment 2009 ,2009,Appropriated,-95118,4165381,T-109
1227,Lawrence/Broadway,North Side,2025-12-31,"SBIF (1M auth., 750K remaining) ",2009,Appropriated,-250000,3915381,T-109
1228,Lawrence/Broadway,North Side,2025-12-31,Uptown Goldblatt's LLC Project Note Payment 2009 ,2009,Appropriated,-304452,3610929,T-109
1229,Lawrence/Broadway,North Side,2025-12-31,Uptown Goldblatts LLC Area Wide Note Payment 2009 ,2009,Appropriated,-564469,3046460,T-109
1230,Lawrence/Broadway,North Side,2025-12-31,Port to Hollywood/Sheridan for Hollywood House cash payment ,2009,Appropriated,-1000000,2046460,T-109
1231,Lawrence/Broadway,North Side,2025-12-31,Port from Edgewater for SBIF ,2009,Committed,250000,2296460,T-109
1232,Lawrence/Broadway,North Side,2025-12-31,Professional Services - Environmental review ,2009,Committed,-50000,2246460,T-109
1233,Lawrence/Broadway,North Side,2025-12-31,Leland Hotel 2009 payment ,2009,Committed,-50000,2196460,T-109
1234,Lawrence/Broadway,North Side,2025-12-31,Estimated Incremental Property Tax Revenue ,2010,Committed,2703391,4899852,T-109
1235,Lawrence/Broadway,North Side,2025-12-31,Leland Hotel 2010 Payment ,2010,Committed,-50000,4849852,T-109
1236,Lawrence/Broadway,North Side,2025-12-31,Administrative Costs ,2010,Committed,-51500,4798352,T-109
1237,Lawrence/Broadway,North Side,2025-12-31,Gunnison Lofts Note Payment 2010 ,2010,Committed,-95118,4703234,T-109
1238,Lawrence/Broadway,North Side,2025-12-31,Uptown Broadway Building ,2010,Committed,-150000,4553234,T-109
1239,Lawrence/Broadway,North Side,2025-12-31,Uptown Goldblatts LLC Project Note Payment 2010 ,2010,Committed,-304452,4248782,T-109
1240,Lawrence/Broadway,North Side,2025-12-31,Uptown Goldblatts LLC Area Wide Note Payment 2010 ,2010,Committed,-564469,3684313,T-109
1241,Lawrence/Broadway,North Side,2025-12-31,Estimated Incremental Property Tax Revenue ,2011,Committed,2703391,6387704,T-109
1242,Lawrence/Broadway,North Side,2025-12-31,Leland Hotel 2011 payment ,2011,Committed,-50000,6337704,T-109
1243,Lawrence/Broadway,North Side,2025-12-31,Administrative Costs ,2011,Committed,-51500,6286204,T-109
1244,Lawrence/Broadway,North Side,2025-12-31,Gunnison Lofts Note Payment 2011 ,2011,Committed,-95118,6191086,T-109
1245,Lawrence/Broadway,North Side,2025-12-31,Uptown Broadway Building ,2011,Committed,-150000,6041086,T-109
1246,Lawrence/Broadway,North Side,2025-12-31,Uptown Goldblatt's LLC Project Note Payment 2011 ,2011,Committed,-304452,5736634,T-109
1247,Lawrence/Broadway,North Side,2025-12-31,Uptown Goldblatts LLC Area Wide Note Payment 2011 ,2011,Committed,-564469,5172165,T-109
1248,Lawrence/Kedzie,Northwest Side,2024-12-31,FY Beginning Cash Balance ,2009,Appropriated,9483338,9483338,T- 88
1249,Lawrence/Kedzie,Northwest Side,2024-12-31,Fencing for Ronan Park expansion ,2009,Appropriated,-18000,9465338,T- 88
1250,Lawrence/Kedzie,Northwest Side,2024-12-31,Professional Services  -- TIF amendment ,2009,Appropriated,-200000,9265338,T- 88
1251,Lawrence/Kedzie,Northwest Side,2024-12-31,ADA ramps @ Kedzie and Ainslie ,2009,Committed,-25000,9240338,T- 88
1252,Lawrence/Kedzie,Northwest Side,2024-12-31,NIF Note Debt Service 2009 ,2009,Committed,-160625,9079713,T- 88
1253,Lawrence/Kedzie,Northwest Side,2024-12-31,Kiwanis Park- artifical turf ,2009,Committed,-475000,8604713,T- 88
1254,Lawrence/Kedzie,Northwest Side,2024-12-31,"Lighting- Foster & Lawrence, btwn Kedzie & the river. ",2009,Committed,-500000,8104713,T- 88
1255,Lawrence/Kedzie,Northwest Side,2024-12-31,NIF ,2009,Committed,-1000000,7104713,T- 88
1256,Lawrence/Kedzie,Northwest Side,2024-12-31,Ronan Park expansion - replacement of state grant amt. ,2009,Committed,-1060000,6044713,T- 88
1257,Lawrence/Kedzie,Northwest Side,2024-12-31,Ronan Park expansion ,2009,Committed,-4850000,1194713,T- 88
1258,Lawrence/Kedzie,Northwest Side,2024-12-31,Neighborhood Identifier Study ,2009,Pending,-30000,1164713,T- 88
1259,Lawrence/Kedzie,Northwest Side,2024-12-31,Estimated Incremental Property Tax Revenue ,2010,Committed,6425000,7589713,T- 88
1260,Lawrence/Kedzie,Northwest Side,2024-12-31,Bus pad @ Kimbal / Bryn Mawr ,2010,Committed,-18000,7571713,T- 88
1261,Lawrence/Kedzie,Northwest Side,2024-12-31,"Street Resurfacing: Spaulding, Lawrence to Ainsle ",2010,Committed,-33230,7538483,T- 88
1262,Lawrence/Kedzie,Northwest Side,2024-12-31,"WPA street: Winona, Albany to Troy  -- design ",2010,Committed,-45000,7493483,T- 88
1263,Lawrence/Kedzie,Northwest Side,2024-12-31,Administrative Costs ,2010,Committed,-114000,7379483,T- 88
1264,Lawrence/Kedzie,Northwest Side,2024-12-31,NIF Note Debt Service 2010 ,2010,Committed,-148750,7230733,T- 88
1265,Lawrence/Kedzie,Northwest Side,2024-12-31,"Green Alley: Argyle, Ainslie, River, Whipple ",2010,Committed,-206000,7024733,T- 88
1266,Lawrence/Kedzie,Northwest Side,2024-12-31,"Streetscape- Foster, Albany to Kimball  -- construction - match to Federal Funds ",2010,Committed,-400000,6624733,T- 88
1267,Lawrence/Kedzie,Northwest Side,2024-12-31,"WPA street: Winona, Albany to Troy  -- const. ",2010,Committed,-640000,5984733,T- 88
1268,Lawrence/Kedzie,Northwest Side,2024-12-31,GO Bond Debt Service 2010 - Albany Park Academy & Peterson ,2010,Committed,-2485420,3499313,T- 88
1269,Lawrence/Kedzie,Northwest Side,2024-12-31,"Sidewalks: Argyle, Kedzie to 1st alley ",2010,On Hold,-15982,3483331,T- 88
1270,Lawrence/Kedzie,Northwest Side,2024-12-31,"Sidewalks: Leland, Central Park to 1st alley ",2010,On Hold,-17428,3465903,T- 88
1271,Lawrence/Kedzie,Northwest Side,2024-12-31,"Sidewalks: Leland, St. Louis to 1st alley ",2010,On Hold,-21147,3444756,T- 88
1272,Lawrence/Kedzie,Northwest Side,2024-12-31,"Sidewalks: Sawyer, Leland to Lawrence ",2010,On Hold,-47482,3397274,T- 88
1273,Lawrence/Kedzie,Northwest Side,2024-12-31,"Street Resurfacing: Leland, Hamlin to Lawndale ",2010,On Hold,-67754,3329520,T- 88
1274,Lawrence/Kedzie,Northwest Side,2024-12-31,"Street Resurfacing: Ainsle, Kedzie to Kimball ",2010,On Hold,-96226,3233294,T- 88
1275,Lawrence/Kedzie,Northwest Side,2024-12-31,"Curb & Gutter: Leland, St. Louis to Kimball ",2010,On Hold,-220111,3013183,T- 88
1276,Lawrence/Kedzie,Northwest Side,2024-12-31,Lighting: Hamlin / Lawrence / Kimball / Wilson ,2010,On Hold,-1105000,1908183,T- 88
1277,Lawrence/Kedzie,Northwest Side,2024-12-31,Estimated Incremental Property Tax Revenue ,2011,Committed,6425000,8333183,T- 88
1278,Lawrence/Kedzie,Northwest Side,2024-12-31,Administrative Costs ,2011,Committed,-114000,8219183,T- 88
1279,Lawrence/Kedzie,Northwest Side,2024-12-31,NIF Note Debt Service 2011 ,2011,Committed,-136875,8082308,T- 88
1280,Lawrence/Kedzie,Northwest Side,2024-12-31,GO Bond Debt Service 2011 - Albany Park Academy & Peterson ,2011,Committed,-3236925,4845383,T- 88
1281,Lawrence/Pulaski,Northwest Side,2026-12-31,FY Beginning Cash Balance ,2009,Appropriated,3680718,3680718,T-116
1282,Lawrence/Pulaski,Northwest Side,2026-12-31,Pre-acquisition account  -- add'l ,2009,Appropriated,-30000,3650718,T-116
1283,Lawrence/Pulaski,Northwest Side,2026-12-31,Diagonal Parking: Keystone Ave - Elton to first alley south ,2009,Appropriated,-44000,3606718,T-116
1284,Lawrence/Pulaski,Northwest Side,2026-12-31,"Street resurfacing: Keystone, Lawrence to Ainslie ",2009,Appropriated,-44530,3562188,T-116
1285,Lawrence/Pulaski,Northwest Side,2026-12-31,"Sidewalks and tree grates on Wilson, Pulaski to first alley  -- east ",2009,Appropriated,-81232,3480956,T-116
1286,Lawrence/Pulaski,Northwest Side,2026-12-31,Traffic signal @ Pulaski & Leland ,2009,Appropriated,-325000,3155956,T-116
1287,Lawrence/Pulaski,Northwest Side,2026-12-31,Estimated Incremental Property Tax Revenue ,2010,Committed,1049956,4205912,T-116
1288,Lawrence/Pulaski,Northwest Side,2026-12-31,Administrative Costs ,2010,Committed,-19980,4185932,T-116
1289,Lawrence/Pulaski,Northwest Side,2026-12-31,Rehab of Old Police Station ,2010,Pending,-500000,3685932,T-116
1290,Lawrence/Pulaski,Northwest Side,2026-12-31,Estimated Incremental Property Tax Revenue ,2011,Committed,1049956,4735888,T-116
1291,Lawrence/Pulaski,Northwest Side,2026-12-31,Administrative Costs ,2011,Committed,-19980,4715908,T-116
1292,Lincoln/Belmont/Ashland,North Side,2017-11-02,FY Beginning Cash Balance ,2009,Appropriated,87186,87186,T- 28
1293,Lincoln/Belmont/Ashland,North Side,2017-11-02,Comptroller's Account  -- debt ,2009,Appropriated,-4775,82411,T- 28
1294,Lincoln/Belmont/Ashland,North Side,2017-11-02,Left Turn Arrow @ Linclon Belmont Ashland Intersection ,2009,Appropriated,-70000,12411,T- 28
1295,Lincoln/Belmont/Ashland,North Side,2017-11-02,Estimated Incremental Property Tax Revenue ,2010,Committed,808746,821157,T- 28
1296,Lincoln/Belmont/Ashland,North Side,2017-11-02,Administrative Costs ,2010,Committed,-20520,800637,T- 28
1297,Lincoln/Belmont/Ashland,North Side,2017-11-02,Bond Debt Service  -- 1998B 2010 ,2010,Committed,-161150,639487,T- 28
1298,Lincoln/Belmont/Ashland,North Side,2017-11-02,Bond Debt Service  -- 1998A 2010 ,2010,Committed,-900511,-261024,T- 28
1299,Lincoln/Belmont/Ashland,North Side,2017-11-02,Estimated Incremental Property Tax Revenue ,2011,Committed,808746,547721,T- 28
1300,Lincoln/Belmont/Ashland,North Side,2017-11-02,Administrative Costs ,2011,Committed,-20520,527201,T- 28
1301,Lincoln/Belmont/Ashland,North Side,2017-11-02,Bond Debt Service  -- 1998B 2011 ,2011,Committed,-161150,366051,T- 28
1302,Lincoln/Belmont/Ashland,North Side,2017-11-02,Bond Debt Service  -- 1998A 2011 ,2011,Committed,-962511,-596460,T- 28
1303,Lincoln/Belmont/Ashland,North Side,2017-11-02,FY Beginning Cash Balance ,2009,Appropriated,2649525,2649525,T- 28
1304,Lincoln/Belmont/Ashland,North Side,2017-11-02,Lincoln Village Shopping Center Note Payment ,2009,Appropriated,-359655,2289870,T- 28
1305,Lincoln/Belmont/Ashland,North Side,2017-11-02,Acquisition @ 5900 N. Lincoln Ave. ,2009,Pending,-300000,1989870,T- 28
1306,Lincoln/Belmont/Ashland,North Side,2017-11-02,SBIF - release of remaining authorized amount ,2009,Pending,-500000,1489870,T- 28
1307,Lincoln/Belmont/Ashland,North Side,2017-11-02,Estimated Incremental Property Tax Revenue ,2010,Committed,2184009,3673880,T- 28
1308,Lincoln/Belmont/Ashland,North Side,2017-11-02,Administrative Costs ,2010,Committed,-45300,3628580,T- 28
1309,Lincoln/Belmont/Ashland,North Side,2017-11-02,Lincoln Village Shopping Center Note Payment ,2010,Committed,-386000,3242580,T- 28
1310,Lincoln/Belmont/Ashland,North Side,2017-11-02,Chaville Condominiums Payment I ,2010,Committed,-550000,2692580,T- 28
1311,Lincoln/Belmont/Ashland,North Side,2017-11-02,MSAC Ph.1 Debt Service 2010 - Lincoln Ave. share - Mather HS ,2010,Committed,-816670,1875910,T- 28
1312,Lincoln/Belmont/Ashland,North Side,2017-11-02,Estimated Incremental Property Tax Revenue ,2011,Committed,2184009,4059919,T- 28
1313,Lincoln/Belmont/Ashland,North Side,2017-11-02,Administrative Costs ,2011,Committed,-45300,4014619,T- 28
1314,Lincoln/Belmont/Ashland,North Side,2017-11-02,Lincoln Village Shopping Center Note Payment ,2011,Committed,-385817,3628802,T- 28
1315,Lincoln/Belmont/Ashland,North Side,2017-11-02,Chaville Condominiums Payment II ,2011,Committed,-550000,3078802,T- 28
1316,Lincoln/Belmont/Ashland,North Side,2017-11-02,MSAC Ph.1 Debt Service 2011 - Lincoln Ave. share - Mather HS ,2011,Committed,-946303,2132499,T- 28
1317,Little Village,West Side,2031-12-31,FY Beginning Cash Balance ,2009,Appropriated,582231,582231,T-152
1318,Little Village,West Side,2031-12-31,Port to Little Village East ,2009,Appropriated,-2500,579731,T-152
1319,Little Village,West Side,2031-12-31,GO Reimbursement for TIF Eligiblity Study ,2009,Committed,-150000,429731,T-152
1320,Little Village,West Side,2031-12-31,Demo Washburn school ,2009,Pending,0,429731,T-152
1321,Little Village,West Side,2031-12-31,Estimated Incremental Property Tax Revenue ,2010,Committed,582200,1011931,T-152
1322,Little Village,West Side,2031-12-31,Administration ,2010,Committed,0,1011931,T-152
1323,Little Village,West Side,2031-12-31,Estimated Incremental Property Tax Revenue ,2011,Committed,582200,1594131,T-152
1324,Madden/Wells,South Side,2026-12-31,FY Beginning Cash Balance ,2009,Appropriated,778182,778182,T-126
1325,Madden/Wells,South Side,2026-12-31,Demolition reimbursement ,2009,Appropriated,-6800,771382,T-126
1326,Madden/Wells,South Side,2026-12-31,Community Reinvestment Fund Payment ,2009,Appropriated,-191030,580352,T-126
1327,Madden/Wells,South Side,2026-12-31,Oakwood Shores Phase 1B ,2009,Appropriated,-255266,325086,T-126
1328,Madden/Wells,South Side,2026-12-31,Port from 43rd/Cottage for acquisition ,2009,Committed,700000,1025086,T-126
1329,Madden/Wells,South Side,2026-12-31,Pre-acquisition ,2009,Committed,-10000,1015086,T-126
1330,Madden/Wells,South Side,2026-12-31,Estimated Incremental Property Tax Revenue ,2010,Committed,396410,1411496,T-126
1331,Madden/Wells,South Side,2026-12-31,Administrative Costs ,2010,Committed,-5700,1405796,T-126
1332,Madden/Wells,South Side,2026-12-31,Mercy Oakwood  -- own PINs RDA payment ,2010,Committed,-200000,1205796,T-126
1333,Madden/Wells,South Side,2026-12-31,Oakwood Shores II  -- For sale ,2010,Pending,0,1205796,T-126
1334,Madden/Wells,South Side,2026-12-31,Estimated Incremental Property Tax Revenue ,2011,Committed,396410,1602206,T-126
1335,Madden/Wells,South Side,2026-12-31,Administrative Costs ,2011,Committed,-5700,1596506,T-126
1336,Madden/Wells,South Side,2026-12-31,Mercy Oakwood  -- own PINs RDA payment ,2011,Committed,-200000,1396506,T-126
1337,Madden/Wells,South Side,2026-12-31,Oakwood Shores II  -- For sale ,2011,Pending,0,1396506,T-126
1338,Madison/Austin,West Side,2023-12-31,FY Beginning Cash Balance ,2009,Appropriated,2411190,2411190,T- 75
1339,Madison/Austin,West Side,2023-12-31,Viaduct repairs: Corcaoran & Mayfield ,2009,Appropriated,-35248,2375942,T- 75
1340,Madison/Austin,West Side,2023-12-31,MOWD - job training in Ward 28 ,2009,Appropriated,-94000,2281942,T- 75
1341,Madison/Austin,West Side,2023-12-31,"Piggyback lighting: Madison, Hamlin to Pine ",2009,Appropriated,-330000,1951942,T- 75
1342,Madison/Austin,West Side,2023-12-31,Legler Library Repairs ,2009,Committed,-250000,1701942,T- 75
1343,Madison/Austin,West Side,2023-12-31,Port to Harrison/Central for 2009 Loretto Hospital room payment ,2009,Committed,-375000,1326942,T- 75
1344,Madison/Austin,West Side,2023-12-31,Payoff of Outstanding Bank Note Balance ,2009,Committed,-403051,923891,T- 75
1345,Madison/Austin,West Side,2023-12-31,"SBIF (750K auth., 250k remaining) ",2009,Committed,-500000,423891,T- 75
1346,Madison/Austin,West Side,2023-12-31,Estimated Incremental Property Tax Revenue ,2010,Committed,1758440,2182331,T- 75
1347,Madison/Austin,West Side,2023-12-31,Administrative Costs ,2010,Committed,-29500,2152831,T- 75
1348,Madison/Austin,West Side,2023-12-31,Lake and Waller Note 1 payment ,2010,Committed,-200000,1952831,T- 75
1349,Madison/Austin,West Side,2023-12-31,Port to Harrison/Central for 2010 Loretto Hospital room payment ,2010,Committed,-375000,1577831,T- 75
1350,Madison/Austin,West Side,2023-12-31,MSAC Ph.1 Debt Service 2010 - Madison/Austin share - Austin HS & DePriest ,2010,Committed,-632056,945775,T- 75
1351,Madison/Austin,West Side,2023-12-31,Land Disposition ,2010,Pending,-50000,895775,T- 75
1352,Madison/Austin,West Side,2023-12-31,Estimated Incremental Property Tax Revenue ,2011,Committed,1758440,2654215,T- 75
1353,Madison/Austin,West Side,2023-12-31,Administrative Costs ,2011,Committed,-29500,2624715,T- 75
1354,Madison/Austin,West Side,2023-12-31,Lake and Waller Note 1 Payment ,2011,Committed,-200000,2424715,T- 75
1355,Madison/Austin,West Side,2023-12-31,Port to Harrison/Central for 2011 Loretto Hospital room payment ,2011,Committed,-375000,2049715,T- 75
1356,Madison/Austin,West Side,2023-12-31,MSAC Ph.1 Debt Service 2010 - Madison/Austin share - Austin HS & DePriest ,2011,Committed,-771140,1278575,T- 75
1357,Madison/Austin,West Side,2023-12-31,Port from Midwest for Lake/Corocoran streetscaping ,2011,Pending,2280000,3558575,T- 75
1358,Madison/Austin,West Side,2023-12-31,Lake/Corcoran Streetscaping  -- with Midwest ported funds ,2011,Pending,-2280000,1278575,T- 75
1359,Michigan/Cermak,Central,2012-09-13,FY Beginning Cash Balance ,2009,Appropriated,946410,946410,T- 29
1360,Michigan/Cermak,Central,2012-09-13,"Luminary replacement: Wabash, Cermak to just south of 21st ",2009,Appropriated,-32000,914410,T- 29
1361,Michigan/Cermak,Central,2012-09-13,Demolition account increase ,2009,Appropriated,-42100,872310,T- 29
1362,Michigan/Cermak,Central,2012-09-13,"Arterial streets ADA ramps design & construction  (min = 21,700 for design) ",2009,Appropriated,-155500,716810,T- 29
1363,Michigan/Cermak,Central,2012-09-13,Teachers Academy Note Payment 2010 - port to 24th/Michigan TIF ,2009,Appropriated,-195000,521810,T- 29
1364,Michigan/Cermak,Central,2012-09-13,Teachers Academy Note Payment 2009 - port to 24th/Michigan TIF ,2009,Appropriated,-195000,326810,T- 29
1365,Michigan/Cermak,Central,2012-09-13,"Streetscape resurfacing- Michgain Ave, Roosevelt to 24th. ",2009,Committed,-240000,86810,T- 29
1366,Michigan/Cermak,Central,2012-09-13,Broadband Initiative ,2009,Pending,-41616,45194,T- 29
1367,Michigan/Cermak,Central,2012-09-13,Estimated Incremental Property Tax Revenue ,2010,Committed,694373,739567,T- 29
1368,Michigan/Cermak,Central,2012-09-13,Administrative Costs ,2010,Committed,-8800,730767,T- 29
1369,Michigan/Cermak,Central,2012-09-13,Estimated Incremental Property Tax Revenue ,2011,Committed,694373,1425140,T- 29
1370,Michigan/Cermak,Central,2012-09-13,Administrative Costs ,2011,Committed,-8800,1416340,T- 29
1371,Michigan/Cermak,Central,2012-09-13,Teachers Academy Note Payment 2011 - port to 24th/Michigan TIF ,2011,Committed,-195000,1221340,T- 29
1372,Midway Industrial Corridor,Southwest Side,2024-12-31,FY Beginning Cash Balance ,2009,Appropriated,3117316,3117316,T- 89
1373,Midway Industrial Corridor,Southwest Side,2024-12-31,TIF Works  -- Ordinance Passed 2005 ,2009,Pending,-100000,3017316,T- 89
1374,Midway Industrial Corridor,Southwest Side,2024-12-31,Estimated Incremental Property Tax Revenue ,2010,Committed,1424753,4442069,T- 89
1375,Midway Industrial Corridor,Southwest Side,2024-12-31,Administrative Costs ,2010,Committed,-30119,4411950,T- 89
1376,Midway Industrial Corridor,Southwest Side,2024-12-31,MSAC Ph.1 Debt Service 2010 - port to 51st/Archer - Southwest Elem. ,2010,Committed,-729070,3682880,T- 89
1377,Midway Industrial Corridor,Southwest Side,2024-12-31,Pre-Acquisition/Disposition ,2010,Pending,-50000,3632880,T- 89
1378,Midway Industrial Corridor,Southwest Side,2024-12-31,SBIF ,2010,Pending,-500000,3132880,T- 89
1379,Midway Industrial Corridor,Southwest Side,2024-12-31,Estimated Incremental Property Tax Revenue ,2011,Committed,1424753,4557633,T- 89
1380,Midway Industrial Corridor,Southwest Side,2024-12-31,Administrative Costs ,2011,Committed,-30119,4527514,T- 89
1381,Midway Industrial Corridor,Southwest Side,2024-12-31,MSAC Ph.1 Debt Service 2011 - port to 51st/Archer - Southwest Elem. ,2011,Committed,-856313,3671201,T- 89
1382,Midway Industrial Corridor,Southwest Side,2024-12-31,Pre-Acquisition/Disposition ,2011,Pending,-50000,3621201,T- 89
1383,Midwest,West Side,2024-12-31,FY Beginning Cash Balance ,2009,Appropriated,12970325,12970325,T- 95
1384,Midwest,West Side,2024-12-31,24th Ward Alley Lighting ,2009,Appropriated,-27150,12943175,T- 95
1385,Midwest,West Side,2024-12-31,Safe Routes to Schools match  -- sidewalks & bike lanes @ St. Agatha Elem. ,2009,Appropriated,-40000,12903175,T- 95
1386,Midwest,West Side,2024-12-31,"Street resurfacing: Flournoy, Kedzie to Albany ",2009,Appropriated,-97856,12805319,T- 95
1387,Midwest,West Side,2024-12-31,"Lighting: Washington & Warren, Sacramento to Western ",2009,Appropriated,-100000,12705319,T- 95
1388,Midwest,West Side,2024-12-31,Liberty Square Payment  -- DOH - 2009 ,2009,Appropriated,-121804,12583516,T- 95
1389,Midwest,West Side,2024-12-31,"Street resurfacing: Roosevelt, Homan to St. Louis ",2009,Appropriated,-185296,12398220,T- 95
1390,Midwest,West Side,2024-12-31,TIF Works ,2009,Appropriated,-200000,12198220,T- 95
1391,Midwest,West Side,2024-12-31,Ward 2 trees ,2009,Appropriated,-205000,11993220,T- 95
1392,Midwest,West Side,2024-12-31,"Stamped sidewalks: Warren, Sacramento to Washington; Sacremento, Francisco to Wa ",2009,Appropriated,-210000,11783220,T- 95
1393,Midwest,West Side,2024-12-31,"Piggyback lighting: Madison, Sacramento to Pine ",2009,Appropriated,-477000,11306220,T- 95
1394,Midwest,West Side,2024-12-31,Viaduct clearance improvements @ 1010 S. California Ave. ,2009,Appropriated,-611200,10695020,T- 95
1395,Midwest,West Side,2024-12-31,Lawndale Restoration  -- Holstein Escrow Amount 2009 ,2009,Appropriated,-1450000,9245020,T- 95
1396,Midwest,West Side,2024-12-31,Streetscape: Western Ave. Phase 2 ,2009,Appropriated,-2000000,7245020,T- 95
1397,Midwest,West Side,2024-12-31,"Lighting change-outs & piggybacks: Madison, Sacraemento to Western ",2009,Committed,-63100,7181920,T- 95
1398,Midwest,West Side,2024-12-31,"Street resurfacing: Roosevelt, St. Louis to Central Park ",2009,Committed,-180459,7001461,T- 95
1399,Midwest,West Side,2024-12-31,MOWD MOU - job training in Ward 28 ,2009,Committed,-200000,6801461,T- 95
1400,Midwest,West Side,2024-12-31,"Streetscape: Roosevelt Rd., Albany to Homan  -- Design ",2009,Committed,-275000,6526461,T- 95
1401,Midwest,West Side,2024-12-31,Lighting: various locations ,2009,Committed,-500000,6026461,T- 95
1402,Midwest,West Side,2024-12-31,Viaduct clearance ,2009,Committed,-611200,5415261,T- 95
1403,Midwest,West Side,2024-12-31,CPS ADA projects  -- Dodge ,2009,Committed,-750000,4665261,T- 95
1404,Midwest,West Side,2024-12-31,"Resurfacing: Warren, California to Western ",2009,Committed,-890000,3775261,T- 95
1405,Midwest,West Side,2024-12-31,Midwest TIF Note Series 2002: Debt Service 2009  -- 1 of 4 remaining ,2009,Committed,-1096000,2679261,T- 95
1406,Midwest,West Side,2024-12-31,"Streetscape: Western Ave.  -- Ph. 1, Van Buren to Monroe  -- constr. ",2009,Committed,-2000000,679261,T- 95
1407,Midwest,West Side,2024-12-31,Payoff of Outstanding Bank Note Balance ,2009,Committed,-3094000,-2414739,T- 95
1408,Midwest,West Side,2024-12-31,Viaduct lighting  -- power cables 1000 S. Independence ,2009,Pending,0,-2414739,T- 95
1409,Midwest,West Side,2024-12-31,Broadband Initiative ,2009,Pending,-700000,-3114739,T- 95
1410,Midwest,West Side,2024-12-31,Streetscaping  -- locations TBD ,2009,Pending,-1019300,-4134039,T- 95
1411,Midwest,West Side,2024-12-31,Heritage Homes RDA ,2009,Pending,-1750000,-5884039,T- 95
1412,Midwest,West Side,2024-12-31,Estimated Incremental Property Tax Revenue ,2010,Committed,13000000,7115961,T- 95
1413,Midwest,West Side,2024-12-31,Liberty Square Payment  -- DOH - 2010 ,2010,Committed,-108000,7007961,T- 95
1414,Midwest,West Side,2024-12-31,Administrative Costs ,2010,Committed,-197500,6810461,T- 95
1415,Midwest,West Side,2024-12-31,MSAC Ph.1 Debt Service 2010 - port to Madison/Austin - Austin HS & DePriest ,2010,Committed,-734298,6076163,T- 95
1416,Midwest,West Side,2024-12-31,"Street Resurface: Madison, California to Western ",2010,Committed,-890000,5186163,T- 95
1417,Midwest,West Side,2024-12-31,Lawndale Restoration  -- Holstein Escrow Amount 2010 ,2010,Committed,-1000000,4186163,T- 95
1418,Midwest,West Side,2024-12-31,Midwest TIF Note Series 2002: Debt Service 2010  -- 1 of 3 remaining ,2010,Committed,-1032000,3154163,T- 95
1419,Midwest,West Side,2024-12-31,MSAC Ph.1 Debt Service 2010 - port to Chicago/Central Park - Westinghouse ,2010,Committed,-1212691,1941472,T- 95
1420,Midwest,West Side,2024-12-31,Heritage Homes ,2010,Committed,-1750000,191472,T- 95
1421,Midwest,West Side,2024-12-31,MSAC Ph.1 Debt Service 2010 - Midwest share - Collins ,2010,Committed,-2120975,-1929503,T- 95
1422,Midwest,West Side,2024-12-31,"Streetscape- Roosevelt Rd, Albany to Homan  -- Construction ",2010,Committed,-2412500,-4342003,T- 95
1423,Midwest,West Side,2024-12-31,Potential Redevelopment Project ,2010,Committed,-2500000,-6842003,T- 95
1424,Midwest,West Side,2024-12-31,Estimated Incremental Property Tax Revenue ,2011,Committed,13000000,6157997,T- 95
1425,Midwest,West Side,2024-12-31,Liberty Square Payment  -- DOH - 2011 ,2011,Committed,-108000,6049997,T- 95
1426,Midwest,West Side,2024-12-31,Administrative Costs ,2011,Committed,-197500,5852497,T- 95
1427,Midwest,West Side,2024-12-31,Midwest TIF Note Series 2002: Debt Service 2011  -- 1 of 2 remaining ,2011,Committed,-968000,4884497,T- 95
1428,Midwest,West Side,2024-12-31,MSAC Ph.1 Debt Service 2011 - port to Madison/Austin - Austin HS & DePriest ,2011,Committed,-981127,3903370,T- 95
1429,Midwest,West Side,2024-12-31,MSAC Ph.1 Debt Service 2011 - port to Chicago/Central Park - Westinghouse ,2011,Committed,-1316412,2586958,T- 95
1430,Midwest,West Side,2024-12-31,MSAC Ph.1 Debt Service 2011 - Midwest share - Collins ,2011,Committed,-2300450,286508,T- 95
1431,Midwest,West Side,2024-12-31,Potential Redevelopment Project ,2011,Committed,-2500000,-2213492,T- 95
1432,Midwest,West Side,2024-12-31,Potential Redevelopment Project ,2011,Committed,-5000000,-7213492,T- 95
1433,Montclare,Northwest Side,2024-12-31,FY Beginning Cash Balance ,2009,Appropriated,506920,506920,T-102
1434,Montclare,Northwest Side,2024-12-31,Montclare Senior Housing Phase II Note Payment ,2009,Appropriated,-121269,385651,T-102
1435,Montclare,Northwest Side,2024-12-31,Montclare Senior Housing Phase I Note Payment ,2009,Appropriated,-142704,242946,T-102
1436,Montclare,Northwest Side,2024-12-31,Estimated Incremental Property Tax Revenue ,2010,Committed,390274,633220,T-102
1437,Montclare,Northwest Side,2024-12-31,Administrative Costs ,2010,Committed,-11500,621720,T-102
1438,Montclare,Northwest Side,2024-12-31,Montclare Senior Housing Phase II Note Payment ,2010,Committed,-121269,500451,T-102
1439,Montclare,Northwest Side,2024-12-31,Montclare Senior Housing Phase I Note Payment ,2010,Committed,-142704,357747,T-102
1440,Montclare,Northwest Side,2024-12-31,Estimated Incremental Property Tax Revenue ,2011,Committed,390274,748021,T-102
1441,Montclare,Northwest Side,2024-12-31,Administrative Costs ,2011,Committed,-11500,736521,T-102
1442,Montclare,Northwest Side,2024-12-31,Montclare Senior Housing Phase II Note Payment ,2011,Committed,-121269,615252,T-102
1443,Montclare,Northwest Side,2024-12-31,Montclare Senior Housing Phase I Note Payment ,2011,Committed,-142704,472548,T-102
1444,Near West,Central,2020-07-30,FY Beginning Cash Balance ,2009,Appropriated,22555614,22555614,T- 32
1445,Near West,Central,2020-07-30,Pre-acquisition Account Increase ,2009,Appropriated,-35000,22520614,T- 32
1446,Near West,Central,2020-07-30,SBIF ,2009,Appropriated,-500000,22020614,T- 32
1447,Near West,Central,2020-07-30,"Lighting: Sedgewick, North to Division ",2009,Appropriated,-650000,21370614,T- 32
1448,Near West,Central,2020-07-30,River Village Site G Note Payment  -- payment 2 ,2009,Appropriated,-802458,20568156,T- 32
1449,Near West,Central,2020-07-30,Halsted St. Bridge reconstruction  -- add'l ,2009,Appropriated,-836000,19732156,T- 32
1450,Near West,Central,2020-07-30,River Village Site G Note Payment  -- payment 1 ,2009,Appropriated,-1428431,18303725,T- 32
1451,Near West,Central,2020-07-30,"Speed humps: 1400-1600 Orleans, Evergreen to North ",2009,Committed,-7000,18296725,T- 32
1452,Near West,Central,2020-07-30,Transit Grant for CHA Plan For Transformation ,2009,Committed,-53446,18243279,T- 32
1453,Near West,Central,2020-07-30,"Concrete restoration of lightpoles: Sedgewick, North to Division ",2009,Committed,-150000,18093279,T- 32
1454,Near West,Central,2020-07-30,Traffic Signal: Blackhawk & Halsted ,2009,Committed,-400000,17693279,T- 32
1455,Near West,Central,2020-07-30,Annual Bond Program Expenses  -- 2009 ,2009,Committed,-784021,16909258,T- 32
1456,Near West,Central,2020-07-30,CHA Transformation: acquisition @ 1316 N. Halsted  -- Mickey Brown ,2009,Committed,-2000000,14909258,T- 32
1457,Near West,Central,2020-07-30,"CPS ADA projects  -- Manierre, Schiller ",2009,Committed,-2250000,12659258,T- 32
1458,Near West,Central,2020-07-30,Port to North Branch North for Kingsbury rail removal ,2009,Committed,-2500000,10159258,T- 32
1459,Near West,Central,2020-07-30,"Halsted Streetlights  -- Division to Blackhawk, west side only ",2009,Pending,-32400,10126858,T- 32
1460,Near West,Central,2020-07-30,Halsted St. bridge  -- add'l ,2009,Proposed,-200000,9926858,T- 32
1461,Near West,Central,2020-07-30,Eng. Co. 4 renovation ,2009,Requested,-2000000,7926858,T- 32
1462,Near West,Central,2020-07-30,Estimated Incremental Property Tax Revenue ,2010,Committed,13034788,20961646,T- 32
1463,Near West,Central,2020-07-30,Administrative Costs ,2010,Committed,-260500,20701146,T- 32
1464,Near West,Central,2020-07-30,Annual Bond Program Expenses  -- 2010 ,2010,Committed,-784021,19917125,T- 32
1465,Near West,Central,2020-07-30,Parkside Old Town Note Payment ,2010,Committed,-1000000,18917125,T- 32
1466,Near West,Central,2020-07-30,Bond Debt Service 2010  -- final payment due 2019 - Series A ,2010,Committed,-5035280,13881845,T- 32
1467,Near West,Central,2020-07-30,Estimated Incremental Property Tax Revenue ,2011,Committed,13034788,26916632,T- 32
1468,Near West,Central,2020-07-30,Administrative Costs ,2011,Committed,-260500,26656132,T- 32
1469,Near West,Central,2020-07-30,River Village Site G Note Payment  -- payment 3 ,2011,Committed,-802458,25853674,T- 32
1470,Near West,Central,2020-07-30,Parkside at Old Town Note Payment ,2011,Committed,-2700000,23153674,T- 32
1471,Near West,Central,2020-07-30,Bond Debt Service 2011  -- final payment due 2019 - Series A ,2011,Committed,-5077676,18075998,T- 32
1472,Near West,Central,2020-07-30,CHA Transformation: Ogden RFP ,2011,Pending,-1500000,16575998,T- 32
1473,Near West,Central,2020-07-30,CHA Transformation: Oak/Larrabee ,2011,Pending,-1500000,15075998,T- 32
1474,Near West,Central,2020-07-30,CHA Transformation: Clybourn Division II ,2011,Pending,-2000000,13075998,T- 32
1475,Near West,Central,2020-07-30,FY Beginning Cash Balance ,2009,Appropriated,36331872,36331872,T- 32
1476,Near West,Central,2020-07-30,Budget Liquidation: Congress Streetscape - Michgan to Wells  -- Fed Funds ,2009,Appropriated,3182520,39514392,T- 32
1477,Near West,Central,2020-07-30,Mark Twain Park Env. Assessment ,2009,Appropriated,-71000,39443392,T- 32
1478,Near West,Central,2020-07-30,Central Business District Underground Mapping Intiative Phase 3 ,2009,Appropriated,-123746,39319647,T- 32
1479,Near West,Central,2020-07-30,Demolition account increase ,2009,Appropriated,-169000,39150647,T- 32
1480,Near West,Central,2020-07-30,"Streetscape: Wabash, Harrison to Roosevelt; lighting  -- add'l ",2009,Appropriated,-300000,38850647,T- 32
1481,Near West,Central,2020-07-30,"Streetscape: Wabash, Harrison to Roosevelt; lighting  -- add'l ",2009,Appropriated,-415000,38435647,T- 32
1482,Near West,Central,2020-07-30,"Arterial streets ADA ramps design & construction  -- min = 46,500 for design ",2009,Appropriated,-444500,37991147,T- 32
1483,Near West,Central,2020-07-30,Environmental Assessment and remediation for proposed park @ 16th & Wabash ,2009,Appropriated,-985000,37006147,T- 32
1484,Near West,Central,2020-07-30,Acquisition Account  -- add'l ,2009,Appropriated,-1055000,35951147,T- 32
1485,Near West,Central,2020-07-30,Harold Washington Library electrical system control ,2009,Appropriated,-2000000,33951147,T- 32
1486,Near West,Central,2020-07-30,Washington Library facade work ,2009,Appropriated,-2000000,31951147,T- 32
1487,Near West,Central,2020-07-30,Spertus RDA payment ,2009,Appropriated,-3000000,28951147,T- 32
1488,Near West,Central,2020-07-30,Congress Streetscape - Michgan to Wells  -- add'l ,2009,Appropriated,-4852560,24098587,T- 32
1489,Near West,Central,2020-07-30,Central Station Final Note Payment ,2009,Appropriated,-10081503,14017084,T- 32
1490,Near West,Central,2020-07-30,Near South Parking Study ,2009,Committed,-60000,13957084,T- 32
1491,Near West,Central,2020-07-30,"Luminary replacemen: Wabash, Roosevelt to Cermak ",2009,Committed,-320000,13637084,T- 32
1492,Near West,Central,2020-07-30,16th/Wabash Park Improvements ,2009,Committed,-2479000,11158084,T- 32
1493,Near West,Central,2020-07-30,Tom Sawyer Park - environmental remediation ,2009,Committed,-3000000,8158084,T- 32
1494,Near West,Central,2020-07-30,Vietnam Vets Museum Facility Improvements ,2009,Pending,-1550000,6608084,T- 32
1495,Near West,Central,2020-07-30,Estimated Incremental Property Tax Revenue ,2010,Committed,41500000,48108084,T- 32
1496,Near West,Central,2020-07-30,Administrative Costs ,2010,Committed,-689750,47418334,T- 32
1497,Near West,Central,2020-07-30,Blackstone Hotel- Note Payment ,2010,Committed,-1226000,46192334,T- 32
1498,Near West,Central,2020-07-30,"L'Oreal, Phase I Payment ",2010,Committed,-1250000,44942334,T- 32
1499,Near West,Central,2020-07-30,Bond Debt Service 2010 ,2010,Committed,-9598015,35344319,T- 32
1500,Near West,Central,2020-07-30,Jones HS IGA  -- CPS ,2010,Committed,-24000000,11344319,T- 32
1501,Near West,Central,2020-07-30,Estimated Incremental Property Tax Revenue ,2011,Committed,41500000,52844319,T- 32
1502,Near West,Central,2020-07-30,Administrative Costs ,2011,Committed,-689750,52154569,T- 32
1503,Near West,Central,2020-07-30,Blackstone Hotel- Note Payment ,2011,Committed,-1226000,50928569,T- 32
1504,Near West,Central,2020-07-30,Bond Debt Service 2011 ,2011,Committed,-9608015,41320554,T- 32
1505,Near West,Central,2020-07-30,Jones HS IGA  -- CPS ,2011,Pending,-38000000,3320554,T- 32
1506,Near West,Central,2020-07-30,FY Beginning Cash Balance ,2009,Appropriated,35400910,35400910,T- 32
1507,Near West,Central,2020-07-30,Central Business District Underground Mapping Intiative Phase 3 ,2009,Appropriated,-87206,35313704,T- 32
1508,Near West,Central,2020-07-30,TIF Works ,2009,Appropriated,-100000,35213704,T- 32
1509,Near West,Central,2020-07-30,"Street resurfacing: Adams, Paulina to Halsted ",2009,Committed,-1975000,33238704,T- 32
1510,Near West,Central,2020-07-30,Port to Central West  -- Sangamon Park Phase I Construction ,2009,Committed,-4000000,29238704,T- 32
1511,Near West,Central,2020-07-30,Rush RDA payment no. 1 ,2009,Committed,-10668000,18570704,T- 32
1512,Near West,Central,2020-07-30,Green Streetscaping ,2009,Pending,-1000000,17570704,T- 32
1513,Near West,Central,2020-07-30,Pocket Park  -- acquisition & development ,2009,Pending,-2500000,15070704,T- 32
1514,Near West,Central,2020-07-30,Estimated Incremental Property Tax Revenue ,2010,Committed,9596071,24666775,T- 32
1515,Near West,Central,2020-07-30,Administrative Costs ,2010,Committed,-182600,24484175,T- 32
1516,Near West,Central,2020-07-30,"Street resurfacing: Madison, Racine to Halsted ",2010,Committed,-890000,23594175,T- 32
1517,Near West,Central,2020-07-30,Bond Debt Service 2010 ,2010,Committed,-1295300,22298875,T- 32
1518,Near West,Central,2020-07-30,Port to Central/West  -- Monroe-Sangamon Park Phase II - Demo/Env./Buildout ,2010,Committed,-2000000,20298875,T- 32
1519,Near West,Central,2020-07-30,MSAC Ph.1 Debt Service 2010 - port to Central West - Skinner Elem. ,2010,Committed,-4220475,16078401,T- 32
1520,Near West,Central,2020-07-30,Rush RDA payment no. 2 ,2010,Committed,-17386050,-1307649,T- 32
1521,Near West,Central,2020-07-30,RDA: Gateway to West Loop  -- 1 of 5 ,2010,Pending,-1640000,-2947649,T- 32
1522,Near West,Central,2020-07-30,RDA: West Loop Promenade  -- 1 of 5 ,2010,Pending,-1950000,-4897649,T- 32
1523,Near West,Central,2020-07-30,Estimated Incremental Property Tax Revenue ,2011,Committed,9596071,4698422,T- 32
1524,Near West,Central,2020-07-30,Administrative Costs ,2011,Committed,-182600,4515822,T- 32
1525,Near West,Central,2020-07-30,Bond Debt Service 2011 ,2011,Committed,-1292400,3223422,T- 32
1526,Near West,Central,2020-07-30,MSAC Ph.1 Debt Service 2011 - port to Central West - Skinner Elem. ,2011,Committed,-4504376,-1280955,T- 32
1527,Near West,Central,2020-07-30,Rush RDA payment no. 3 ,2011,Committed,-9070600,-10351555,T- 32
1528,Near West,Central,2020-07-30,RDA: Gateway to West Loop  -- 2 of 5 ,2011,Pending,-1640000,-11991555,T- 32
1529,Near West,Central,2020-07-30,RDA: West Loop Promenade  -- 2 of 5 ,2011,Pending,-1950000,-13941555,T- 32
1530,North/Cicero,Northwest Side,2020-07-30,FY Beginning Cash Balance ,2009,Appropriated,1616627,1616627,T- 35
1531,North/Cicero,Northwest Side,2020-07-30,CTA IGA payment 2009 ,2009,Appropriated,-324331,1292296,T- 35
1532,North/Cicero,Northwest Side,2020-07-30,SBIF ,2009,Appropriated,-500000,792296,T- 35
1533,North/Cicero,Northwest Side,2020-07-30,North & Cicero Development L.L.C. Note Payment ,2009,Appropriated,-836092,-43796,T- 35
1534,North/Cicero,Northwest Side,2020-07-30,"Streetscape - North Ave, Grand to Chicago ",2009,Pending,0,-43796,T- 35
1535,North/Cicero,Northwest Side,2020-07-30,Estimated Incremental Property Tax Revenue ,2010,Committed,813609,769813,T- 35
1536,North/Cicero,Northwest Side,2020-07-30,Administrative Costs ,2010,Committed,-22000,747813,T- 35
1537,North/Cicero,Northwest Side,2020-07-30,"WPA Street Reconstruction - Lamon, Le Moyne to first alley south.  -- Design ",2010,Pending,-45000,702813,T- 35
1538,North/Cicero,Northwest Side,2020-07-30,"WPA Street Reconstruction-Lamon, Le Moyne to first alley south -- Construction ",2010,Pending,-600000,102813,T- 35
1539,North/Cicero,Northwest Side,2020-07-30,Estimated Incremental Property Tax Revenue ,2011,Committed,813609,916422,T- 35
1540,North/Cicero,Northwest Side,2020-07-30,Administrative Costs ,2011,Committed,-22000,894422,T- 35
1541,North/Cicero,Northwest Side,2020-07-30,FY Beginning Cash Balance ,2009,Appropriated,15609514,15609514,T- 35
1542,North/Cicero,Northwest Side,2020-07-30,Preacquisition account increase ,2009,Appropriated,-25000,15584514,T- 35
1543,North/Cicero,Northwest Side,2020-07-30,Damen/Elston/Fullerton Intersection Improvement - Planning Study ,2009,Committed,-100000,15484514,T- 35
1544,North/Cicero,Northwest Side,2020-07-30,Seawall Program  -- RIF ,2009,Committed,-500000,14984514,T- 35
1545,North/Cicero,Northwest Side,2020-07-30,TIF Works ,2009,Committed,-500000,14484514,T- 35
1546,North/Cicero,Northwest Side,2020-07-30,SBIF ,2009,Committed,-500000,13984514,T- 35
1547,North/Cicero,Northwest Side,2020-07-30,North Branch Truck Study - Phase I  -- Feasibility ,2009,Committed,-500000,13484514,T- 35
1548,North/Cicero,Northwest Side,2020-07-30,Damen/Elston/Fullerton Intersection - ROW Eng. and Acq. ,2009,Committed,-20000000,-6515486,T- 35
1549,North/Cicero,Northwest Side,2020-07-30,"Street reconstruction: Lister, Damen to Webster ",2009,Proposed,-1525000,-8040486,T- 35
1550,North/Cicero,Northwest Side,2020-07-30,Estimated Incremental Property Tax Revenue ,2010,Committed,4101753,-3938734,T- 35
1551,North/Cicero,Northwest Side,2020-07-30,Administrative Costs ,2010,Committed,-75800,-4014534,T- 35
1552,North/Cicero,Northwest Side,2020-07-30,TIF Works ,2010,Pending,-500000,-4514534,T- 35
1553,North/Cicero,Northwest Side,2020-07-30,SBIF ,2010,Pending,-500000,-5014534,T- 35
1554,North/Cicero,Northwest Side,2020-07-30,Seawall Program  -- RIF ,2010,Pending,-600000,-5614534,T- 35
1555,North/Cicero,Northwest Side,2020-07-30,Street Imrovements: N. Wood-Webster south to end of street ,2010,Pending,-650000,-6264534,T- 35
1556,North/Cicero,Northwest Side,2020-07-30,Estimated Incremental Property Tax Revenue ,2011,Committed,4101753,-2162781,T- 35
1557,North/Cicero,Northwest Side,2020-07-30,Administrative Costs ,2011,Committed,-75800,-2238581,T- 35
1558,North/Cicero,Northwest Side,2020-07-30,Damen/Elston/Fullerton Intersection - ROW Eng. and Acq. ,2011,Committed,-7000000,-9238581,T- 35
1559,North/Cicero,Northwest Side,2020-07-30,TIF Works ,2011,Pending,-500000,-9738581,T- 35
1560,North/Cicero,Northwest Side,2020-07-30,SBIF ,2011,Pending,-500000,-10238581,T- 35
1561,North/Cicero,Northwest Side,2020-07-30,Seawall Program  -- RIF ,2011,Pending,-600000,-10838581,T- 35
1562,North/Cicero,Northwest Side,2020-07-30,FY Beginning Cash Balance ,2009,Appropriated,16434745,16434745,T- 35
1563,North/Cicero,Northwest Side,2020-07-30,Demolition account increase ,2009,Appropriated,-13800,16420945,T- 35
1564,North/Cicero,Northwest Side,2020-07-30,Cherry Ave. Railroad bridge repair  -- add'l ,2009,Appropriated,-700000,15720945,T- 35
1565,North/Cicero,Northwest Side,2020-07-30,"Halsted Triangle Area Imp.  -- Kingsbury Parking & Streetscape, design &eng. ",2009,Appropriated,-2000000,13720945,T- 35
1566,North/Cicero,Northwest Side,2020-07-30,Halsted Triangle Improvements - Construction ,2009,Appropriated,-4250000,9470945,T- 35
1567,North/Cicero,Northwest Side,2020-07-30,"Industrial Street Improvements Elston & Wabansia  -- Fleet Mgt Area, construction ",2009,Appropriated,-7400000,2070945,T- 35
1568,North/Cicero,Northwest Side,2020-07-30,Port from Near North for infrastructure projects ,2009,Committed,2500000,4570945,T- 35
1569,North/Cicero,Northwest Side,2020-07-30,Halsted Triangle Parking Study  -- Ph. 2 ,2009,Committed,-50000,4520945,T- 35
1570,North/Cicero,Northwest Side,2020-07-30,McGrath-Lexus Riverwall ,2009,Committed,-191400,4329545,T- 35
1571,North/Cicero,Northwest Side,2020-07-30,North Branch Truckway - Cost/Benefit Analysis Study ,2009,Committed,-350000,3979545,T- 35
1572,North/Cicero,Northwest Side,2020-07-30,Street Resurfacing Evergreen to Kingsbury ,2009,Committed,-430000,3549545,T- 35
1573,North/Cicero,Northwest Side,2020-07-30,"Industrial Street Improvements Elston & Besley  -- Fleet Mgt Area, construction ",2009,Committed,-2000000,1549545,T- 35
1574,North/Cicero,Northwest Side,2020-07-30,Halsted Triangle Area Improvements  -- ind. Kingsbury Parking & Streetscape ,2009,Pending,-150000,1399545,T- 35
1575,North/Cicero,Northwest Side,2020-07-30,General Iron Riverwall Improvement  -- 1901 N. Clifton ,2009,Pending,-300000,1099545,T- 35
1576,North/Cicero,Northwest Side,2020-07-30,TIF Works ,2009,Pending,-500000,599545,T- 35
1577,North/Cicero,Northwest Side,2020-07-30,AAA Boatyard/River Edge Stabilization  -- a.k.a. Goose Island Overlook Park ,2009,Pending,-500000,99545,T- 35
1578,North/Cicero,Northwest Side,2020-07-30,Seawall Program ,2009,Pending,-600000,-500455,T- 35
1579,North/Cicero,Northwest Side,2020-07-30,Ogden Ave. Median Culdesac Fry St. to RR Viaduct ,2009,Pending,-650000,-1150455,T- 35
1580,North/Cicero,Northwest Side,2020-07-30,"Industrial Street Improvements Elston & Besley  -- Fleet Mgt Area, study ",2009,Proposed,-500000,-1650455,T- 35
1581,North/Cicero,Northwest Side,2020-07-30,Estimated Incremental Property Tax Revenue ,2010,Committed,4584541,2934086,T- 35
1582,North/Cicero,Northwest Side,2020-07-30,Administrative Costs ,2010,Committed,-90200,2843886,T- 35
1583,North/Cicero,Northwest Side,2020-07-30,Lab Facility Fund ,2010,Pending,-100000,2743886,T- 35
1584,North/Cicero,Northwest Side,2020-07-30,Street Imp. Potomac to Elston ,2010,Pending,-250000,2493886,T- 35
1585,North/Cicero,Northwest Side,2020-07-30,TIF Works ,2010,Pending,-500000,1993886,T- 35
1586,North/Cicero,Northwest Side,2020-07-30,SBIF ,2010,Pending,-500000,1493886,T- 35
1587,North/Cicero,Northwest Side,2020-07-30,Seawall Program ,2010,Pending,-1000000,493886,T- 35
1588,North/Cicero,Northwest Side,2020-07-30,Bigane Paving Expansion ,2010,Pending,-2000000,-1506114,T- 35
1589,North/Cicero,Northwest Side,2020-07-30,Estimated Incremental Property Tax Revenue ,2011,Committed,4584541,3078427,T- 35
1590,North/Cicero,Northwest Side,2020-07-30,Administrative Costs ,2011,Committed,-90200,2988227,T- 35
1591,North/Cicero,Northwest Side,2020-07-30,TIF Works ,2011,Pending,-500000,2488227,T- 35
1592,North/Cicero,Northwest Side,2020-07-30,Seawall Program ,2011,Pending,-1000000,1488227,T- 35
1593,Northwest Industrial Corridor,Northwest Side,2021-12-02,FY Beginning Cash Balance ,2009,Appropriated,11105940,11105940,T- 64
1594,Northwest Industrial Corridor,Northwest Side,2021-12-02,Pedestrian countdown signal @ Fullerton & Kostner ,2009,Appropriated,-12000,11093940,T- 64
1595,Northwest Industrial Corridor,Northwest Side,2021-12-02,"Street: Homer, Kilbourn to dead-end  -- add'l ",2009,Appropriated,-20000,11073940,T- 64
1596,Northwest Industrial Corridor,Northwest Side,2021-12-02,"Sidewalks: Kilbourn, Division to Haddon ",2009,Appropriated,-30000,11043940,T- 64
1597,Northwest Industrial Corridor,Northwest Side,2021-12-02,Pre-Acquisition Account ,2009,Appropriated,-50000,10993940,T- 64
1598,Northwest Industrial Corridor,Northwest Side,2021-12-02,Demolition account increase ,2009,Appropriated,-102600,10891340,T- 64
1599,Northwest Industrial Corridor,Northwest Side,2021-12-02,Merlin/Coke RDA ,2009,Appropriated,-215000,10676340,T- 64
1600,Northwest Industrial Corridor,Northwest Side,2021-12-02,TIF Works ,2009,Appropriated,-300000,10376340,T- 64
1601,Northwest Industrial Corridor,Northwest Side,2021-12-02,SBIF ,2009,Appropriated,-500000,9876340,T- 64
1602,Northwest Industrial Corridor,Northwest Side,2021-12-02,CPD IGA - Orr Park ,2009,Appropriated,-600000,9276340,T- 64
1603,Northwest Industrial Corridor,Northwest Side,2021-12-02,"Industrial Street Improvements: Kolmar, Cortez, Kilbourn ",2009,Appropriated,-2600000,6676340,T- 64
1604,Northwest Industrial Corridor,Northwest Side,2021-12-02,"Sidewalks: Homer, Klibourn to Kenton ",2009,Committed,-20000,6656340,T- 64
1605,Northwest Industrial Corridor,Northwest Side,2021-12-02,Diagonal parking: Fullerton to 1st alley  -- south ,2009,Committed,-30000,6626340,T- 64
1606,Northwest Industrial Corridor,Northwest Side,2021-12-02,Diagonal Parking: Division to 1st Alley ,2009,Committed,-35735,6590605,T- 64
1607,Northwest Industrial Corridor,Northwest Side,2021-12-02,Diagonal Parking: Fullerton to 1st alley  -- north ,2009,Committed,-39554,6551051,T- 64
1608,Northwest Industrial Corridor,Northwest Side,2021-12-02,"800 N. Cicero , Left Turn Signal ",2009,Committed,-50000,6501051,T- 64
1609,Northwest Industrial Corridor,Northwest Side,2021-12-02,Traffic signal upgrades :Hirsh / Kostner ,2009,Committed,-65000,6436051,T- 64
1610,Northwest Industrial Corridor,Northwest Side,2021-12-02,Traffic signal upgrades: North / Grand / Kostner ,2009,Committed,-144000,6292051,T- 64
1611,Northwest Industrial Corridor,Northwest Side,2021-12-02,"Street Resurfacing: Kostner, North to Hirsh  -- east side of street ",2009,Committed,-187000,6105051,T- 64
1612,Northwest Industrial Corridor,Northwest Side,2021-12-02,"Street Resurfacing: Kostner, Hirsh to Division ",2009,Committed,-375000,5730051,T- 64
1613,Northwest Industrial Corridor,Northwest Side,2021-12-02,"SBIF (500k of 1M auth, 500k remaining) ",2009,Committed,-500000,5230051,T- 64
1614,Northwest Industrial Corridor,Northwest Side,2021-12-02,Greenbaum Park expansion  -- North Grand High School Campus ,2009,Committed,-1970000,3260051,T- 64
1615,Northwest Industrial Corridor,Northwest Side,2021-12-02,Demolition: 1642 N. Kostner ,2009,Pending,-80000,3180051,T- 64
1616,Northwest Industrial Corridor,Northwest Side,2021-12-02,Left turn signals  -- east & west bound from Chicago Ave to Pulaski Rd. ,2009,Pending,-100000,3080051,T- 64
1617,Northwest Industrial Corridor,Northwest Side,2021-12-02,Estimated Incremental Property Tax Revenue ,2010,Committed,5712022,8792073,T- 64
1618,Northwest Industrial Corridor,Northwest Side,2021-12-02,MSAC Ph.1 Debt Service 2010 - port to Galewood/Armitage - Belmont Cragin ,2010,Committed,-92014,8700059,T- 64
1619,Northwest Industrial Corridor,Northwest Side,2021-12-02,Administrative Costs ,2010,Committed,-108700,8591359,T- 64
1620,Northwest Industrial Corridor,Northwest Side,2021-12-02,Merlin/Coke RDA ,2010,Committed,-215000,8376359,T- 64
1621,Northwest Industrial Corridor,Northwest Side,2021-12-02,Home Depot RDA payment ,2010,Committed,-300000,8076359,T- 64
1622,Northwest Industrial Corridor,Northwest Side,2021-12-02,Brachs Redvelopment  -- 401 N. Cicero ,2010,Committed,-400000,7676359,T- 64
1623,Northwest Industrial Corridor,Northwest Side,2021-12-02,"SBIF (500k of 1M auth, 0 remaining) ",2010,Committed,-500000,7176359,T- 64
1624,Northwest Industrial Corridor,Northwest Side,2021-12-02,MSAC Ph.1 Debt Service 2010 - port to Chicago/Central Park - Westinghouse ,2010,Committed,-1137363,6038996,T- 64
1625,Northwest Industrial Corridor,Northwest Side,2021-12-02,MSAC Ph.1 Debt Service 2010 - port to Madison/Austin - Austin HS ,2010,Committed,-1371546,4667449,T- 64
1626,Northwest Industrial Corridor,Northwest Side,2021-12-02,Estimated Incremental Property Tax Revenue ,2011,Committed,5712022,10379471,T- 64
1627,Northwest Industrial Corridor,Northwest Side,2021-12-02,Administrative Costs ,2011,Committed,-108700,10270771,T- 64
1628,Northwest Industrial Corridor,Northwest Side,2021-12-02,MSAC Ph.1 Debt Service 2011 - port to Galewood/Armitage - Belmont Cragin ,2011,Committed,-121350,10149421,T- 64
1629,Northwest Industrial Corridor,Northwest Side,2021-12-02,Merlin/Coke RDA ,2011,Committed,-215000,9934421,T- 64
1630,Northwest Industrial Corridor,Northwest Side,2021-12-02,Home Depot RDA payment ,2011,Committed,-300000,9634421,T- 64
1631,Northwest Industrial Corridor,Northwest Side,2021-12-02,MSAC Ph.1 Debt Service 2011 - port to Chicago/Central Park - Westinghouse ,2011,Committed,-1105836,8528586,T- 64
1632,Northwest Industrial Corridor,Northwest Side,2021-12-02,MSAC Ph.1 Debt Service 2011 - port to Madison/Austin - Austin HS ,2011,Committed,-1810433,6718153,T- 64
1633,Ogden/Pulaski,Southwest Side,2032-12-31,FY Beginning Cash Balance ,2009,Appropriated,0,0,T-161
1634,Ogden/Pulaski,Southwest Side,2032-12-31,Administration ,2009,Committed,0,0,T-161
1635,Ogden/Pulaski,Southwest Side,2032-12-31,Reimbursement for TIF study  -- est. ,2009,Committed,-100000,-100000,T-161
1636,Ogden/Pulaski,Southwest Side,2032-12-31,"Green Alley: Genshaw, Roosevelt, Keeler, and Kildare ",2009,On Hold,0,-100000,T-161
1637,Ogden/Pulaski,Southwest Side,2032-12-31,"Street resurfacing: Kevdale, 16th to 18th ",2009,On Hold,-48904,-148904,T-161
1638,Ogden/Pulaski,Southwest Side,2032-12-31,"Street resurfacing:Lawndale, Cermak to Ogden ",2009,On Hold,-49038,-197942,T-161
1639,Ogden/Pulaski,Southwest Side,2032-12-31,"Sreet resurfacing: Bross St, Western to Hoyne ",2009,On Hold,-171566,-369508,T-161
1640,Ogden/Pulaski,Southwest Side,2032-12-31,Alley reconstruction: 13th / Karlov/ Kedvale / 14th ,2009,On Hold,-219000,-588508,T-161
1641,Ogden/Pulaski,Southwest Side,2032-12-31,Alley reconstruction: Cullerton / Kildare / 21st / Kostner ,2009,On Hold,-295000,-883508,T-161
1642,Ogden/Pulaski,Southwest Side,2032-12-31,Estimated Incremental Property Tax Revenue ,2010,Committed,0,-883508,T-161
1643,Ogden/Pulaski,Southwest Side,2032-12-31,Estimated Incremental Property Tax Revenue ,2011,Committed,0,-883508,T-161
1644,Ohio/Wabash,Central,2024-12-31,FY Beginning Cash Balance ,2009,Appropriated,1238345,1238345,T-100
1645,Ohio/Wabash,Central,2024-12-31,Medinah Temple Note Payment ,2009,Appropriated,-1238345,0,T-100
1646,Ohio/Wabash,Central,2024-12-31,Estimated Incremental Property Tax Revenue ,2010,Committed,1238345,1238345,T-100
1647,Ohio/Wabash,Central,2024-12-31,Medinah Temple Note Payment ,2010,Committed,-1238345,0,T-100
1648,Ohio/Wabash,Central,2024-12-31,Estimated Incremental Property Tax Revenue ,2011,Committed,1238345,1238345,T-100
1649,Ohio/Wabash,Central,2024-12-31,Medinah Temple Note Payment ,2011,Committed,-1238345,0,T-100
1650,Pershing?King,South Side,2031-12-31,Port from 47th/King for Paul G. Stewart ,2009,Appropriated,1500000,1500000,T-154
1651,Pershing?King,South Side,2031-12-31,FY Beginning Cash Balance ,2009,Appropriated,93351,1593351,T-154
1652,Pershing?King,South Side,2031-12-31,Paul G. Stewart Apt. closing and coc payment ,2009,Appropriated,-1500000,93351,T-154
1653,Pershing?King,South Side,2031-12-31,Broadband Initiative ,2009,Pending,-42034,51317,T-154
1654,Pershing?King,South Side,2031-12-31,Port from 47th/King for Paul G. Stewart ,2010,Committed,352200,403517,T-154
1655,Pershing?King,South Side,2031-12-31,Estimated Incremental Property Tax Revenue ,2010,Committed,94000,497517,T-154
1656,Pershing?King,South Side,2031-12-31,Paul G. Stewart Apt. 1st anniversary payment ,2010,Committed,-352200,145317,T-154
1657,Pershing?King,South Side,2031-12-31,Neighborhood Improvement Fund ,2010,Committed,-500000,-354683,T-154
1658,Pershing?King,South Side,2031-12-31,Port from 47th/King for Paul G. Stewart ,2011,Committed,352500,-2183,T-154
1659,Pershing?King,South Side,2031-12-31,Estimated Incremental Property Tax Revenue ,2011,Committed,94000,91817,T-154
1660,Pershing?King,South Side,2031-12-31,Paul G. Stewart Apt. second anniversary payment ,2011,Committed,-352200,-260383,T-154
1661,Peterson/Cicero,Northwest Side,2024-12-31,FY Beginning Cash Balance ,2009,Appropriated,439074,439074,T- 90
1662,Peterson/Cicero,Northwest Side,2024-12-31,"Lighting: Cicero, Peterson to Glenlake ",2009,Appropriated,-300000,139074,T- 90
1663,Peterson/Cicero,Northwest Side,2024-12-31,"Sidewalk & Lighting: Cicero, Peterson to Glenlake ",2009,Appropriated,-386963,-247889,T- 90
1664,Peterson/Cicero,Northwest Side,2024-12-31,Estimated Incremental Property Tax Revenue ,2010,Committed,439000,191111,T- 90
1665,Peterson/Cicero,Northwest Side,2024-12-31,Administrative Costs ,2010,Committed,-340,190771,T- 90
1666,Peterson/Cicero,Northwest Side,2024-12-31,Estimated Incremental Property Tax Revenue ,2011,Committed,439000,629771,T- 90
1667,Peterson/Cicero,Northwest Side,2024-12-31,Administrative Costs ,2011,Committed,-340,629431,T- 90
1668,Peterson/Pulaski,Northwest Side,2023-02-16,FY Beginning Cash Balance ,2009,Appropriated,2783381,2783381,T- 91
1669,Peterson/Pulaski,Northwest Side,2023-02-16,"Sidewalk, curb, gutter: Devon, Pulaski - Springfield  -- add'l ",2009,Appropriated,-9654,2773727,T- 91
1670,Peterson/Pulaski,Northwest Side,2023-02-16,"Lighting improvements: Devon, Pulaski - Springfield  -- add'l ",2009,Appropriated,-97000,2676727,T- 91
1671,Peterson/Pulaski,Northwest Side,2023-02-16,Belltone  -- Centerpoint RDA payment ,2009,Appropriated,-150000,2526727,T- 91
1672,Peterson/Pulaski,Northwest Side,2023-02-16,"Sidewalk, curb, gutter: Devon, Pulaski - Springfield ",2009,Appropriated,-160000,2366727,T- 91
1673,Peterson/Pulaski,Northwest Side,2023-02-16,"Lighting improvements: Devon, Pulaski - Springfield ",2009,Appropriated,-200000,2166727,T- 91
1674,Peterson/Pulaski,Northwest Side,2023-02-16,"SBIF (1M auth; prev. rel. 500k, 0 auth. remaining) ",2009,Appropriated,-500000,1666727,T- 91
1675,Peterson/Pulaski,Northwest Side,2023-02-16,"SBIF (1M auth., 500k auth. remaining) ",2009,Committed,-500000,1166727,T- 91
1676,Peterson/Pulaski,Northwest Side,2023-02-16,Estimated Incremental Property Tax Revenue ,2010,Committed,1064500,2231227,T- 91
1677,Peterson/Pulaski,Northwest Side,2023-02-16,Administrative Costs ,2010,Committed,-17400,2213827,T- 91
1678,Peterson/Pulaski,Northwest Side,2023-02-16,Belltone  -- Centerpoint RDA payment ,2010,Committed,-175000,2038827,T- 91
1679,Peterson/Pulaski,Northwest Side,2023-02-16,Landscape signage Master Plan ,2010,Committed,-500000,1538827,T- 91
1680,Peterson/Pulaski,Northwest Side,2023-02-16,RDA: CCH (5M note note payment  -- est.) ,2010,Committed,-615325,923502,T- 91
1681,Peterson/Pulaski,Northwest Side,2023-02-16,Estimated Incremental Property Tax Revenue ,2011,Committed,1064500,1988002,T- 91
1682,Peterson/Pulaski,Northwest Side,2023-02-16,Administrative Costs ,2011,Committed,-17400,1970602,T- 91
1683,Peterson/Pulaski,Northwest Side,2023-02-16,Belltone  -- Centerpoint RDA payment ,2011,Committed,-175000,1795602,T- 91
1684,Peterson/Pulaski,Northwest Side,2023-02-16,RDA: CCH (5M note note payment  -- est.) ,2011,Committed,-615325,1180277,T- 91
1685,Peterson/Pulaski,Northwest Side,2023-02-16,Landscape signage Master Plan ,2011,Committed,-1500000,-319723,T- 91
1686,Pilsen Industrial Corridor,Southwest Side,2022-12-31,FY Beginning Cash Balance ,2009,Appropriated,9588994,9588994,T- 53
1687,Pilsen Industrial Corridor,Southwest Side,2022-12-31,Demolition account increase ,2009,Appropriated,-4500,9584494,T- 53
1688,Pilsen Industrial Corridor,Southwest Side,2022-12-31,"Trees & tree pits: 29th, south of Stearns Quarry ",2009,Appropriated,-11170,9573324,T- 53
1689,Pilsen Industrial Corridor,Southwest Side,2022-12-31,"Arterial streets ADA ramps design & construction  (min = 18,600 for design) ",2009,Appropriated,-88000,9485324,T- 53
1690,Pilsen Industrial Corridor,Southwest Side,2022-12-31,"Sidewalk replacement: 29th St, Halsted to Poplar ",2009,Appropriated,-140700,9344624,T- 53
1691,Pilsen Industrial Corridor,Southwest Side,2022-12-31,TIF Works ,2009,Appropriated,-150000,9194624,T- 53
1692,Pilsen Industrial Corridor,Southwest Side,2022-12-31,Target RDA note payment ,2009,Appropriated,-914750,8279874,T- 53
1693,Pilsen Industrial Corridor,Southwest Side,2022-12-31,Bridge Repairs @ Canal Street ,2009,Appropriated,-2000000,6279874,T- 53
1694,Pilsen Industrial Corridor,Southwest Side,2022-12-31,Underground tank removal ,2009,Committed,-50000,6229874,T- 53
1695,Pilsen Industrial Corridor,Southwest Side,2022-12-31,"Streetscape: Blue Island, Cullerton to 21st St; design ",2009,Committed,-120000,6109874,T- 53
1696,Pilsen Industrial Corridor,Southwest Side,2022-12-31,"Sidewalk, C&G, trees and grates on Ashland from 2540 to 2600 ",2009,Committed,-133923,5975951,T- 53
1697,Pilsen Industrial Corridor,Southwest Side,2022-12-31,Sidewalks @ 2800 S. Halsted ,2009,Pending,-100000,5875951,T- 53
1698,Pilsen Industrial Corridor,Southwest Side,2022-12-31,Broadband Initiative ,2009,Pending,-180061,5695890,T- 53
1699,Pilsen Industrial Corridor,Southwest Side,2022-12-31,Estimated Incremental Property Tax Revenue ,2010,Committed,7969287,13665178,T- 53
1700,Pilsen Industrial Corridor,Southwest Side,2022-12-31,Administrative Costs ,2010,Committed,-151600,13513578,T- 53
1701,Pilsen Industrial Corridor,Southwest Side,2022-12-31,"Streetscape: Blue Island, Cullerton to 21st St; construction ",2010,Committed,-800000,12713578,T- 53
1702,Pilsen Industrial Corridor,Southwest Side,2022-12-31,CPS Note Payment 2010 - Juarez ,2010,Committed,-830000,11883578,T- 53
1703,Pilsen Industrial Corridor,Southwest Side,2022-12-31,Target RDA note payment ,2010,Committed,-915000,10968578,T- 53
1704,Pilsen Industrial Corridor,Southwest Side,2022-12-31,Bond Debt Service  -- A+B ,2010,Committed,-4953633,6014945,T- 53
1705,Pilsen Industrial Corridor,Southwest Side,2022-12-31,Millenium East ,2010,Pending,-1000000,5014945,T- 53
1706,Pilsen Industrial Corridor,Southwest Side,2022-12-31,Estimated Incremental Property Tax Revenue ,2011,Committed,7969287,12984232,T- 53
1707,Pilsen Industrial Corridor,Southwest Side,2022-12-31,Administrative Costs ,2011,Committed,-151600,12832632,T- 53
1708,Pilsen Industrial Corridor,Southwest Side,2022-12-31,CPS Note Payment 2011 - Juarez ,2011,Committed,-830000,12002632,T- 53
1709,Pilsen Industrial Corridor,Southwest Side,2022-12-31,Target RDA note payment ,2011,Committed,-915000,11087632,T- 53
1710,Pilsen Industrial Corridor,Southwest Side,2022-12-31,Bond Debt Service Payment  -- A+B ,2011,Committed,-4956837,6130795,T- 53
1711,Pilsen Industrial Corridor,Southwest Side,2022-12-31,Traffic signal @ Archer/Lowe/24th Pl ,2011,On Hold,-350000,5780795,T- 53
1712,Portage Park,Northwest Side,2021-09-09,FY Beginning Cash Balance ,2009,Appropriated,5465734,5465734,T- 58
1713,Portage Park,Northwest Side,2021-09-09,Dickenson Park ,2009,On Hold,-50000,5415734,T- 58
1714,Portage Park,Northwest Side,2021-09-09,Viaduct improvements  -- Irving Park Rd- Kilpatrick to Kolmar - Construction ,2009,Pending,-1000000,4415734,T- 58
1715,Portage Park,Northwest Side,2021-09-09,Estimated Incremental Property Tax Revenue ,2010,Committed,2583149,6998883,T- 58
1716,Portage Park,Northwest Side,2021-09-09,Administrative Costs ,2010,Committed,-44400,6954483,T- 58
1717,Portage Park,Northwest Side,2021-09-09,Pre-acquisition Activities ,2010,Committed,-50000,6904483,T- 58
1718,Portage Park,Northwest Side,2021-09-09,Estimated Incremental Property Tax Revenue ,2011,Committed,2583149,9487631,T- 58
1719,Portage Park,Northwest Side,2021-09-09,Administrative Costs ,2011,Committed,-44400,9443231,T- 58
1720,Portage Park,Northwest Side,2021-09-09,CPS IGA for ADA Ph. 2: Schurz  (TPC = 3.6M w/ CPS match of 1.1M) ,2011,Pending,-2500000,6943231,T- 58
1721,Pratt/Ridge,North Side,2028-12-31,FY Beginning Cash Balance ,2009,Appropriated,267146,267146,T-135
1722,Pratt/Ridge,North Side,2028-12-31,Administrative Costs ,2009,Committed,0,267146,T-135
1723,Pratt/Ridge,North Side,2028-12-31,Estimated Incremental Property Tax Revenue ,2010,Committed,267000,534146,T-135
1724,Pratt/Ridge,North Side,2028-12-31,Administrative Costs ,2010,Committed,0,534146,T-135
1725,Pratt/Ridge,North Side,2028-12-31,Estimated Incremental Property Tax Revenue ,2011,Committed,267000,801146,T-135
1726,Pratt/Ridge,North Side,2028-12-31,Administrative Costs ,2011,Committed,0,801146,T-135
1727,Pulaski Industrial Corridor,Northwest Side,2022-06-09,FY Beginning Cash Balance ,2009,Appropriated,5370010,5370010,T- 69
1728,Pulaski Industrial Corridor,Northwest Side,2022-06-09,Demolition account increase ,2009,Appropriated,-4800,5365210,T- 69
1729,Pulaski Industrial Corridor,Northwest Side,2022-06-09,"Street Improvement - Drummond, Keeler to Kildare - add'l for diagonal parking ",2009,Committed,-130000,5235210,T- 69
1730,Pulaski Industrial Corridor,Northwest Side,2022-06-09,SBIF ,2009,Committed,-500000,4735210,T- 69
1731,Pulaski Industrial Corridor,Northwest Side,2022-06-09,CPS ADA projects  -- McAuliffe ,2009,Committed,-750000,3985210,T- 69
1732,Pulaski Industrial Corridor,Northwest Side,2022-06-09,Payoff of Outstanding SBIF Note Balance ,2009,Committed,-866219,3118991,T- 69
1733,Pulaski Industrial Corridor,Northwest Side,2022-06-09,Broadband Initiative ,2009,Pending,-250000,2868991,T- 69
1734,Pulaski Industrial Corridor,Northwest Side,2022-06-09,Estimated Incremental Property Tax Revenue ,2010,Committed,3130639,5999629,T- 69
1735,Pulaski Industrial Corridor,Northwest Side,2022-06-09,Administrative Costs ,2010,Committed,-48300,5951329,T- 69
1736,Pulaski Industrial Corridor,Northwest Side,2022-06-09,MSAC Ph.1 Debt Service 2010 - port to Chicago/Central Park - Westinghouse ,2010,Committed,-802383,5148946,T- 69
1737,Pulaski Industrial Corridor,Northwest Side,2022-06-09,Estimated Incremental Property Tax Revenue ,2011,Committed,3130639,8279585,T- 69
1738,Pulaski Industrial Corridor,Northwest Side,2022-06-09,Administrative Costs ,2011,Committed,-48300,8231285,T- 69
1739,Pulaski Industrial Corridor,Northwest Side,2022-06-09,MSAC Ph.1 Debt Service 2011 - port to Chicago/Central Park - Westinghouse ,2011,Committed,-780141,7451144,T- 69
1740,Ravenswood Corridor,North Side,2029-12-31,FY Beginning Cash Balance ,2009,Appropriated,956187,956187,T-139
1741,Ravenswood Corridor,North Side,2029-12-31,Estimated Incremental Property Tax Revenue ,2010,Committed,677337,1633524,T-139
1742,Ravenswood Corridor,North Side,2029-12-31,Administrative Costs ,2010,Committed,-12850,1620674,T-139
1743,Ravenswood Corridor,North Side,2029-12-31,Estimated Incremental Property Tax Revenue ,2011,Committed,677337,2298011,T-139
1744,Ravenswood Corridor,North Side,2029-12-31,Administrative Costs ,2011,Committed,-12850,2285161,T-139
1745,Read/Dunning,Northwest Side,2015-12-31,FY Beginning Cash Balance ,2009,Appropriated,4432728,4432728,T- 36
1746,Read/Dunning,Northwest Side,2015-12-31,Demolition account increase ,2009,Appropriated,-700000,3732728,T- 36
1747,Read/Dunning,Northwest Side,2015-12-31,Memorial Park ,2009,Committed,0,3732728,T- 36
1748,Read/Dunning,Northwest Side,2015-12-31,Estimated Incremental Property Tax Revenue ,2010,Committed,2261875,5994603,T- 36
1749,Read/Dunning,Northwest Side,2015-12-31,Autumn Green Note Payment  -- pending completion ,2010,Committed,0,5994603,T- 36
1750,Read/Dunning,Northwest Side,2015-12-31,Administrative Costs ,2010,Committed,-45800,5948803,T- 36
1751,Read/Dunning,Northwest Side,2015-12-31,Read Dunning TIF Land Use Project ,2010,Committed,-150000,5798803,T- 36
1752,Read/Dunning,Northwest Side,2015-12-31,Bond Debt Service 2010 ,2010,Committed,-776788,5022015,T- 36
1753,Read/Dunning,Northwest Side,2015-12-31,Estimated Incremental Property Tax Revenue ,2011,Committed,2261875,7283890,T- 36
1754,Read/Dunning,Northwest Side,2015-12-31,Autumn Green Note Payment  -- pending completion ,2011,Committed,0,7283890,T- 36
1755,Read/Dunning,Northwest Side,2015-12-31,Administrative Costs ,2011,Committed,-45800,7238090,T- 36
1756,Read/Dunning,Northwest Side,2015-12-31,Bond Debt Service 2011 ,2011,Committed,-849300,6388790,T- 36
1757,River West,Central,2020-07-30,FY Beginning Cash Balance ,2009,Appropriated,15204085,15204085,T-104
1758,River West,Central,2020-07-30,"Viaduct repair: Wacker, Congress to VanBuren ",2009,Appropriated,-107000,15097085,T-104
1759,River West,Central,2020-07-30,Central Business District Underground Mapping Intiative Phase 3 ,2009,Appropriated,-146117,14950968,T-104
1760,River West,Central,2020-07-30,Alley Reconstruction: 16th St/State/ 17th St/ Dearborn ,2009,Appropriated,-246500,14704468,T-104
1761,River West,Central,2020-07-30,"Arterial streets ADA ramps design & construction  (min = 37,200 for design) ",2009,Appropriated,-305500,14398968,T-104
1762,River West,Central,2020-07-30,"Viaduct repair: Wacker, Congress to VanBuren  -- add'l ",2009,Appropriated,-400000,13998968,T-104
1763,River West,Central,2020-07-30,Wells St. - LaSalle Pk Infrastructure  -- add'l ,2009,Appropriated,-500000,13498968,T-104
1764,River West,Central,2020-07-30,"Water mains: VanBuren, Franklin to Wells ",2009,Appropriated,-1000000,12498968,T-104
1765,River West,Central,2020-07-30,Eng. Co. 1 Renovations ,2009,Appropriated,-1000000,11498968,T-104
1766,River West,Central,2020-07-30,Clark/Taylor LLC Note Payment ,2009,Appropriated,-1222510,10276457,T-104
1767,River West,Central,2020-07-30,"Streetscape - Congress, Michigan to Wells - add'l ",2009,Appropriated,-2926640,7349817,T-104
1768,River West,Central,2020-07-30,Police District 1 repairs ,2009,Appropriated,-3000000,4349817,T-104
1769,River West,Central,2020-07-30,Teachers Academy Note Payment 2010 - port to 24th/Michigan TIF ,2009,Appropriated,-4115000,234817,T-104
1770,River West,Central,2020-07-30,Alley Reconstruction: 16th St/State/ 17th St/ Dearborn  -- add'l ,2009,Committed,-20500,214317,T-104
1771,River West,Central,2020-07-30,Acquisition for Congress Streetscape - match to federal funds ,2009,Committed,-400000,-185683,T-104
1772,River West,Central,2020-07-30,Median work: Roosevelt Rd  -- increase ,2009,Committed,-500000,-685683,T-104
1773,River West,Central,2020-07-30,Median removal on Roosevelt Road Bridge ,2009,Committed,-550000,-1235683,T-104
1774,River West,Central,2020-07-30,Wells St. Project A  -- Roosevelt to 15th design ,2009,Pending,-440000,-1675683,T-104
1775,River West,Central,2020-07-30,Wells St. Project B  -- 15th to 18th design ,2009,Pending,-460000,-2135683,T-104
1776,River West,Central,2020-07-30,Ported funds from Canal/Congress for Ping Tom park - 2010 ,2010,Committed,10000000,7864317,T-104
1777,River West,Central,2020-07-30,Estimated Incremental Property Tax Revenue ,2010,Committed,9439090,17303407,T-104
1778,River West,Central,2020-07-30,Port from Chinatown Basin for Ping Tom Park Expansion ,2010,Committed,2000000,19303407,T-104
1779,River West,Central,2020-07-30,Administrative Costs ,2010,Committed,-174500,19128907,T-104
1780,River West,Central,2020-07-30,Clark/Taylor LLC Note Payment ,2010,Committed,-1225200,17903707,T-104
1781,River West,Central,2020-07-30,"Project B, south of Roosevelt Rd  -- S. Wells, 15th - 18th - acquisition ",2010,Committed,-2000000,15903707,T-104
1782,River West,Central,2020-07-30,Ping Tom Park Improvements  -- park & seawall ,2010,Committed,-12000000,3903707,T-104
1783,River West,Central,2020-07-30,Port from Canal/Congress for Wells St. Project A  -- 15th - 18th Construction ,2010,Pending,8000000,11903707,T-104
1784,River West,Central,2020-07-30,Additional Professional Services ,2010,Pending,-100000,11803707,T-104
1785,River West,Central,2020-07-30,Wells St. Project B  -- 15th to 18th design II ,2010,Pending,-400000,11403707,T-104
1786,River West,Central,2020-07-30,Wells St. Project A  -- 15th to 18th -Construction ,2010,Pending,-12075000,-671293,T-104
1787,River West,Central,2020-07-30,Estimated Incremental Property Tax Revenue ,2011,Committed,9439090,8767797,T-104
1788,River West,Central,2020-07-30,Administrative Costs ,2011,Committed,-174500,8593297,T-104
1789,River West,Central,2020-07-30,Teachers Academy Note Payment 2011 - port to 24th/Michigan TIF ,2011,Committed,-4115000,4478297,T-104
1790,River West,Central,2020-07-30,Ported funds from Canal/Congress for S. Wells Project B ,2011,Pending,25000000,29478297,T-104
1791,River West,Central,2020-07-30,Wells St. Project B  -- 15th to 18th construction ,2011,Pending,-30000000,-521703,T-104
1792,River West,Central,2020-07-30,FY Beginning Cash Balance ,2009,Appropriated,16863146,16863146,T-104
1793,River West,Central,2020-07-30,Pre-acquisition account increase ,2009,Appropriated,-20000,16843146,T-104
1794,River West,Central,2020-07-30,Central Business District Underground Mapping Intiative Phase 3 ,2009,Appropriated,-72881,16770265,T-104
1795,River West,Central,2020-07-30,Blommer's Phase II & III acquisition fees  -- DOL ,2009,Appropriated,-80000,16690265,T-104
1796,River West,Central,2020-07-30,SBIF ,2009,Appropriated,-500000,16190265,T-104
1797,River West,Central,2020-07-30,Blommer RDA: reimbursement for acquisition costs ,2009,Appropriated,-1928455,14261810,T-104
1798,River West,Central,2020-07-30,540 W. Madison RDA  -- ABN AMRO Note Payment 2009 ,2009,Appropriated,-5410791,8851019,T-104
1799,River West,Central,2020-07-30,TIF Works  -- job training ,2009,Committed,-312211,8538808,T-104
1800,River West,Central,2020-07-30,Watersaver Faucet ,2009,Committed,-3000000,5538808,T-104
1801,River West,Central,2020-07-30,Vaulted sidewalks @ Watersaver Faucet ,2009,Pending,0,5538808,T-104
1802,River West,Central,2020-07-30,Estimated Incremental Property Tax Revenue ,2010,Committed,9332405,14871213,T-104
1803,River West,Central,2020-07-30,Jewel RDA Note Payment Area Wide 2010 ,2010,Committed,-150000,14721213,T-104
1804,River West,Central,2020-07-30,Administrative Costs ,2010,Committed,-166000,14555213,T-104
1805,River West,Central,2020-07-30,Jewel RDA Note Payment from PINS 2010 ,2010,Committed,-266626,14288587,T-104
1806,River West,Central,2020-07-30,Additional amount for Bloomers per RDA ,2010,Committed,-500000,13788587,T-104
1807,River West,Central,2020-07-30,540 W. Madison RDA  -- ABN AMRO Note Payment Note Payment 2010 ,2010,Committed,-4981175,8807412,T-104
1808,River West,Central,2020-07-30,Estimated Incremental Property Tax Revenue ,2011,Committed,9332405,18139817,T-104
1809,River West,Central,2020-07-30,Jewel RDA Note Payment Area Wide 2011 ,2011,Committed,-150000,17989817,T-104
1810,River West,Central,2020-07-30,Administrative Costs ,2011,Committed,-166000,17823817,T-104
1811,River West,Central,2020-07-30,Metra Market Note B payment  -- est ,2011,Committed,-467400,17356417,T-104
1812,River West,Central,2020-07-30,Jewel RDA Note Payment from PINS 2011 ,2011,Committed,-596120,16760297,T-104
1813,River West,Central,2020-07-30,Metra Market Note A payment  -- est ,2011,Committed,-934700,15825597,T-104
1814,River West,Central,2020-07-30,540 W. Madison RDA  -- ABN AMRO Note Payment Note Payment 2011 ,2011,Committed,-5105705,10719892,T-104
1815,Roosevelt/Canal,Central,2021-12-31,FY Beginning Cash Balance ,2009,Appropriated,3982137,3982137,T- 39
1816,Roosevelt/Canal,Central,2021-12-31,Central Business District Underground Mapping Intiative Phase 3 ,2009,Appropriated,-11726,3970410,T- 39
1817,Roosevelt/Canal,Central,2021-12-31,United Parcel Service Note Payment ,2009,Appropriated,-3221604,748807,T- 39
1818,Roosevelt/Canal,Central,2021-12-31,Estimated Incremental Property Tax Revenue ,2010,Committed,1189385,1938192,T- 39
1819,Roosevelt/Canal,Central,2021-12-31,Administrative Costs ,2010,Committed,-20000,1918192,T- 39
1820,Roosevelt/Canal,Central,2021-12-31,United Parcel Service Note Payment ,2010,Committed,-1000000,918192,T- 39
1821,Roosevelt/Canal,Central,2021-12-31,Estimated Incremental Property Tax Revenue ,2011,Committed,1189385,2107577,T- 39
1822,Roosevelt/Canal,Central,2021-12-31,Administrative Costs ,2011,Committed,-20000,2087577,T- 39
1823,Roosevelt/Canal,Central,2021-12-31,United Parcel Service Note Payment ,2011,Committed,-1000000,1087577,T- 39
1824,Roosevelt/Canal,Central,2021-12-31,FY Beginning Cash Balance ,2009,Appropriated,2611269,2611269,T- 39
1825,Roosevelt/Canal,Central,2021-12-31,"Speed bumbs: 1821, 1855 and 2001 S. Kilbourn Ave ",2009,Committed,-5250,2606019,T- 39
1826,Roosevelt/Canal,Central,2021-12-31,"Sewer lining and street restoration: Polk, Leamington to Lavergne ",2009,Committed,-360000,2246019,T- 39
1827,Roosevelt/Canal,Central,2021-12-31,Port to Harrison/Central for 2009 Loretto Hospital room payment ,2009,Committed,-375000,1871019,T- 39
1828,Roosevelt/Canal,Central,2021-12-31,SBIF ,2009,Committed,-750000,1121019,T- 39
1829,Roosevelt/Canal,Central,2021-12-31,"Pavement & drainage reconst: Polk, Leamington & Lavaergene ",2009,On Hold,-3300000,-2178981,T- 39
1830,Roosevelt/Canal,Central,2021-12-31,Land Disposition Services ,2009,Pending,-50000,-2228981,T- 39
1831,Roosevelt/Canal,Central,2021-12-31,Estimated Incremental Property Tax Revenue ,2010,Committed,1747169,-481812,T- 39
1832,Roosevelt/Canal,Central,2021-12-31,Administrative Costs ,2010,Committed,-14000,-495812,T- 39
1833,Roosevelt/Canal,Central,2021-12-31,Port to Harrison/Central for 2010 Loretto Hospital room payment ,2010,Committed,-375000,-870812,T- 39
1834,Roosevelt/Canal,Central,2021-12-31,Estimated Incremental Property Tax Revenue ,2011,Committed,1747169,876356,T- 39
1835,Roosevelt/Canal,Central,2021-12-31,Administrative Costs ,2011,Committed,-14000,862356,T- 39
1836,Roosevelt/Canal,Central,2021-12-31,Port to Harrison/Central for 2011 Loretto Hospital room payment ,2011,Committed,-375000,487356,T- 39
1837,Roosevelt/Homan,West Side,2013-12-05,FY Beginning Cash Balance ,2009,Appropriated,4753581,4753581,T- 40
1838,Roosevelt/Homan,West Side,2013-12-05,"Street resurfacing: St. Louis, Grenshaw to Roosevelt ",2009,Appropriated,-34213,4719368,T- 40
1839,Roosevelt/Homan,West Side,2013-12-05,"Street resurfacing: Grenshaw, St. Louis to Central Park ",2009,Appropriated,-102104,4617264,T- 40
1840,Roosevelt/Homan,West Side,2013-12-05,"Street resurfacing: Grenshaw, Homan to St. Louis ",2009,Appropriated,-107828,4509436,T- 40
1841,Roosevelt/Homan,West Side,2013-12-05,"Street resurfacing: Roosevelt, St. Louis to Central Park ",2009,Appropriated,-180459,4328977,T- 40
1842,Roosevelt/Homan,West Side,2013-12-05,"Street resurfacing: Roosevelt, Homan to St. Louis ",2009,Appropriated,-190134,4138843,T- 40
1843,Roosevelt/Homan,West Side,2013-12-05,Street Resurfacing & ADA ramps ,2009,Appropriated,-433984,3704859,T- 40
1844,Roosevelt/Homan,West Side,2013-12-05,"Streetscape: Roosevelt Rd., Albany to Homan  -- Design ",2009,Committed,-275000,3429859,T- 40
1845,Roosevelt/Homan,West Side,2013-12-05,Neighborhood Improvement Program ,2009,Pending,-500000,2929859,T- 40
1846,Roosevelt/Homan,West Side,2013-12-05,Estimated Incremental Property Tax Revenue ,2010,Committed,894577,3824436,T- 40
1847,Roosevelt/Homan,West Side,2013-12-05,Administrative Costs ,2010,Committed,-14100,3810336,T- 40
1848,Roosevelt/Homan,West Side,2013-12-05,"Streetscape- Roosevelt Rd, Albany to Homan  -- Construction ",2010,Committed,-2412500,1397836,T- 40
1849,Roosevelt/Homan,West Side,2013-12-05,Roosevelt Towers Phase I Increment Payment ,2010,Pending,0,1397836,T- 40
1850,Roosevelt/Homan,West Side,2013-12-05,Estimated Incremental Property Tax Revenue ,2011,Committed,894577,2292413,T- 40
1851,Roosevelt/Homan,West Side,2013-12-05,Administrative Costs ,2011,Committed,-14100,2278313,T- 40
1852,Roosevelt/Homan,West Side,2013-12-05,FY Beginning Cash Balance ,2009,Appropriated,2692061,2692061,T- 40
1853,Roosevelt/Homan,West Side,2013-12-05,Roosevelt Square RDA ,2009,Appropriated,-2338365,353696,T- 40
1854,Roosevelt/Homan,West Side,2013-12-05,Professional Services  -- 1421-23 W. Roosevelt Rd. ,2009,Committed,-17500,336196,T- 40
1855,Roosevelt/Homan,West Side,2013-12-05,Estimated Incremental Property Tax Revenue ,2010,Committed,1532101,1868297,T- 40
1856,Roosevelt/Homan,West Side,2013-12-05,ABLA Note Payment- Phase I ,2010,Committed,-2921,1865376,T- 40
1857,Roosevelt/Homan,West Side,2013-12-05,Administrative Costs ,2010,Committed,-16000,1849376,T- 40
1858,Roosevelt/Homan,West Side,2013-12-05,Estimated Incremental Property Tax Revenue ,2011,Committed,1532101,3381477,T- 40
1859,Roosevelt/Homan,West Side,2013-12-05,ABLA Note Payment--Phase I ,2011,Committed,0,3381477,T- 40
1860,Roosevelt/Homan,West Side,2013-12-05,ABLA Note Payment--Phase II ,2011,Committed,0,3381477,T- 40
1861,Roosevelt/Homan,West Side,2013-12-05,Administrative Costs ,2011,Committed,-16000,3365477,T- 40
1862,Roosevelt/Union (UIC),West Side,2022-05-12,FY Beginning Cash Balance ,2009,Appropriated,4307042,4307042,T- 68
1863,Roosevelt/Union (UIC),West Side,2022-05-12,Central Business District Underground Mapping Intiative Phase 3 ,2009,Appropriated,-3284,4303758,T- 68
1864,Roosevelt/Union (UIC),West Side,2022-05-12,UIC Board of Trustees Note Payment 2009 ,2009,Committed,-3709182,594576,T- 68
1865,Roosevelt/Union (UIC),West Side,2022-05-12,Estimated Incremental Property Tax Revenue ,2010,Committed,3732045,4326621,T- 68
1866,Roosevelt/Union (UIC),West Side,2022-05-12,Administrative Costs ,2010,Committed,-60000,4266621,T- 68
1867,Roosevelt/Union (UIC),West Side,2022-05-12,UIC Board of Trustees Note Payment 2010 ,2010,Committed,-3896960,369661,T- 68
1868,Roosevelt/Union (UIC),West Side,2022-05-12,Estimated Incremental Property Tax Revenue ,2011,Committed,3732045,4101706,T- 68
1869,Roosevelt/Union (UIC),West Side,2022-05-12,Administrative Costs ,2011,Committed,-60000,4041706,T- 68
1870,Roosevelt/Union (UIC),West Side,2022-05-12,UIC Board of Trustees Note Payment 2011 ,2011,Committed,-3994384,47322,T- 68
1871,Roseland/Michigan,South Side,2026-12-31,FY Beginning Cash Balance ,2009,Appropriated,777369,777369,T-113
1872,Roseland/Michigan,South Side,2026-12-31,Acquisition - 19-21 East 115th Street ,2009,Committed,0,777369,T-113
1873,Roseland/Michigan,South Side,2026-12-31,Acquisition - 11030 South Michigan ,2009,Committed,0,777369,T-113
1874,Roseland/Michigan,South Side,2026-12-31,Acquisition - 142-144 W. 103rd Street ,2009,Committed,0,777369,T-113
1875,Roseland/Michigan,South Side,2026-12-31,"Lighting: 111th St, Michigan to State ",2009,Committed,-18000,759369,T-113
1876,Roseland/Michigan,South Side,2026-12-31,Lighting: Dauphin to Wentworth ,2009,Committed,-46000,713369,T-113
1877,Roseland/Michigan,South Side,2026-12-31,Roseland Plaza - Acquisition ,2009,Committed,-575000,138369,T-113
1878,Roseland/Michigan,South Side,2026-12-31,Broadband Initiative ,2009,Pending,-250000,-111631,T-113
1879,Roseland/Michigan,South Side,2026-12-31,Roseland Plaza RDA payment ,2009,Pending,-400000,-511631,T-113
1880,Roseland/Michigan,South Side,2026-12-31,Estimated Incremental Property Tax Revenue ,2010,Committed,612920,101288,T-113
1881,Roseland/Michigan,South Side,2026-12-31,Administrative Costs ,2010,Committed,-4200,97088,T-113
1882,Roseland/Michigan,South Side,2026-12-31,Estimated Incremental Property Tax Revenue ,2011,Committed,612920,710008,T-113
1883,Roseland/Michigan,South Side,2026-12-31,Administrative Costs ,2011,Committed,-4200,705808,T-113
1884,Sanitary and Ship Canal,West Side,2014-07-24,FY Beginning Cash Balance ,2009,Appropriated,926655,926655,T- 42
1885,Sanitary and Ship Canal,West Side,2014-07-24,Lighting improvements: Viaduct @ 3300 - 3154 S. California ,2009,Committed,-60000,866655,T- 42
1886,Sanitary and Ship Canal,West Side,2014-07-24,"Lighting improvements: W.35th, California to Campbell ",2009,Committed,-650000,216655,T- 42
1887,Sanitary and Ship Canal,West Side,2014-07-24,Keebler ,2009,Pending,0,216655,T- 42
1888,Sanitary and Ship Canal,West Side,2014-07-24,Estimated Incremental Property Tax Revenue ,2010,Committed,871341,1087995,T- 42
1889,Sanitary and Ship Canal,West Side,2014-07-24,Administrative Costs ,2010,Committed,-22257,1065738,T- 42
1890,Sanitary and Ship Canal,West Side,2014-07-24,Bond Debt Service Payment ,2010,Committed,-644938,420800,T- 42
1891,Sanitary and Ship Canal,West Side,2014-07-24,Estimated Incremental Property Tax Revenue ,2011,Committed,871341,1292141,T- 42
1892,Sanitary and Ship Canal,West Side,2014-07-24,Administrative Costs ,2011,Committed,-22257,1269883,T- 42
1893,Sanitary and Ship Canal,West Side,2014-07-24,Bond Debt Service Payment ,2011,Committed,-642000,627883,T- 42
1894,South Works Industrial,South Side,2024-12-31,FY Beginning Cash Balance ,2009,Appropriated,2275961,2275961,T- 78
1895,South Works Industrial,South Side,2024-12-31,South Chicago Disposition Services ,2009,Pending,-40000,2235961,T- 78
1896,South Works Industrial,South Side,2024-12-31,TOD LEED Study ,2009,Pending,-160000,2075961,T- 78
1897,South Works Industrial,South Side,2024-12-31,LEED ND Assessment Study ,2009,Pending,-185000,1890961,T- 78
1898,South Works Industrial,South Side,2024-12-31,Estimated Incremental Property Tax Revenue ,2010,Committed,853454,2744415,T- 78
1899,South Works Industrial,South Side,2024-12-31,Administrative Costs ,2010,Committed,-16240,2728175,T- 78
1900,South Works Industrial,South Side,2024-12-31,83rd/Burley Streetscaping ,2010,Pending,-900000,1828175,T- 78
1901,South Works Industrial,South Side,2024-12-31,Estimated Incremental Property Tax Revenue ,2011,Committed,853454,2681629,T- 78
1902,South Works Industrial,South Side,2024-12-31,Administrative Costs ,2011,Committed,-16240,2665389,T- 78
1903,South Works Industrial,South Side,2024-12-31,"Street Construction: 87th - 93rd, Buffalo, Burley, Brandon, Houston ",2011,Pending,-5000000,-2334611,T- 78
1904,South Works Industrial,South Side,2024-12-31,FY Beginning Cash Balance ,2009,Appropriated,699522,699522,T- 78
1905,South Works Industrial,South Side,2024-12-31,USX Phase I ,2009,Committed,-110000,589522,T- 78
1906,South Works Industrial,South Side,2024-12-31,Estimated Incremental Property Tax Revenue ,2010,Committed,167089,756610,T- 78
1907,South Works Industrial,South Side,2024-12-31,Administrative Costs ,2010,Committed,-7050,749560,T- 78
1908,South Works Industrial,South Side,2024-12-31,USX Phase I ,2010,Committed,-110000,639560,T- 78
1909,South Works Industrial,South Side,2024-12-31,Estimated Incremental Property Tax Revenue ,2011,Committed,167089,806649,T- 78
1910,South Works Industrial,South Side,2024-12-31,Administrative Costs ,2011,Committed,-7050,799599,T- 78
1911,South Works Industrial,South Side,2024-12-31,USX Phase I ,2011,Committed,-110000,689599,T- 78
1912,Stevenson/Brighton,Southwest Side,2031-12-31,FY Beginning Cash Balance ,2009,Appropriated,820974,820974,T-149
1913,Stevenson/Brighton,Southwest Side,2031-12-31,TIF Study GO Reimbursement ,2009,Appropriated,-46491,774483,T-149
1914,Stevenson/Brighton,Southwest Side,2031-12-31,Pre-acquisition Account ,2009,Appropriated,-50000,724483,T-149
1915,Stevenson/Brighton,Southwest Side,2031-12-31,"Pavement, sidewalk repair: Washtenaw, 36th Pl - 37th St. ",2009,Appropriated,-118721,605762,T-149
1916,Stevenson/Brighton,Southwest Side,2031-12-31,"Pavement, sidewalk repair: Albany, 37th Pl - 37th St. ",2009,Appropriated,-197328,408434,T-149
1917,Stevenson/Brighton,Southwest Side,2031-12-31,Streetlights at Brighton Park I Elem.  -- 38th/California ,2009,Appropriated,-220000,188434,T-149
1918,Stevenson/Brighton,Southwest Side,2031-12-31,"Pavement, sidewalk repair: Albany, 37th Pl - 37th St.  -- add'l ",2009,Committed,-10500,177934,T-149
1919,Stevenson/Brighton,Southwest Side,2031-12-31,"Sreet resurfacing:Washtenaw Ave, 36th to 37th Pl ",2009,Committed,-46476,131458,T-149
1920,Stevenson/Brighton,Southwest Side,2031-12-31,"WPA street: Washtenaw, 36th to 37th Pl ",2009,Committed,-568524,-437066,T-149
1921,Stevenson/Brighton,Southwest Side,2031-12-31,Estimated Incremental Property Tax Revenue ,2010,Committed,820000,382934,T-149
1922,Stevenson/Brighton,Southwest Side,2031-12-31,Estimated Incremental Property Tax Revenue ,2011,Committed,820000,1202934,T-149
1923,Stockyards Southeast Quadrant,South Side,2012-03-09,FY Beginning Cash Balance ,2009,Appropriated,322737,322737,T- 45
1924,Stockyards Southeast Quadrant,South Side,2012-03-09,Property Management Costs ,2009,Pending,-10000,312737,T- 45
1925,Stockyards Southeast Quadrant,South Side,2012-03-09,Pre-Acquisition/Disposition ,2009,Pending,-40000,272737,T- 45
1926,Stockyards Southeast Quadrant,South Side,2012-03-09,TIF Works ,2009,Pending,-100000,172737,T- 45
1927,Stockyards Southeast Quadrant,South Side,2012-03-09,Broadband Initiative ,2009,Pending,-204163,-31426,T- 45
1928,Stockyards Southeast Quadrant,South Side,2012-03-09,Estimated Incremental Property Tax Revenue ,2010,Committed,2132718,2101292,T- 45
1929,Stockyards Southeast Quadrant,South Side,2012-03-09,Administrative Costs ,2010,Committed,-45000,2056292,T- 45
1930,Stockyards Southeast Quadrant,South Side,2012-03-09,Bond Debt Service - 2010 ,2010,Committed,-1759256,297035,T- 45
1931,Stockyards Southeast Quadrant,South Side,2012-03-09,TIF Works ,2010,Pending,-150000,147035,T- 45
1932,Stockyards Southeast Quadrant,South Side,2012-03-09,Estimated Incremental Property Tax Revenue ,2011,Committed,2132718,2279753,T- 45
1933,Stockyards Southeast Quadrant,South Side,2012-03-09,Administrative Costs ,2011,Committed,-45000,2234753,T- 45
1934,Stockyards Southeast Quadrant,South Side,2012-03-09,Bond Debt Service - 2011 ,2011,Committed,-1849331,385422,T- 45
1935,Stockyards Southeast Quadrant,South Side,2012-03-09,FY Beginning Cash Balance ,2009,Appropriated,2315608,2315608,T- 45
1936,Stockyards Southeast Quadrant,South Side,2012-03-09,Pre-Acquisition Account  -- R.E. ,2009,Committed,-100000,2215608,T- 45
1937,Stockyards Southeast Quadrant,South Side,2012-03-09,Stockyards Banners ,2009,Pending,-50000,2165608,T- 45
1938,Stockyards Southeast Quadrant,South Side,2012-03-09,TIF Works ,2009,Pending,-200000,1965608,T- 45
1939,Stockyards Southeast Quadrant,South Side,2012-03-09,SBIF ,2009,Pending,-500000,1465608,T- 45
1940,Stockyards Southeast Quadrant,South Side,2012-03-09,Root St. reconfig.  -- add'l ,2009,Pending,-500000,965608,T- 45
1941,Stockyards Southeast Quadrant,South Side,2012-03-09,Estimated Incremental Property Tax Revenue ,2010,Committed,1613120,2578728,T- 45
1942,Stockyards Southeast Quadrant,South Side,2012-03-09,Administrative Costs ,2010,Committed,-36574,2542154,T- 45
1943,Stockyards Southeast Quadrant,South Side,2012-03-09,Bond Debt Service - 2010 ,2010,Committed,-604050,1938104,T- 45
1944,Stockyards Southeast Quadrant,South Side,2012-03-09,Estimated Incremental Property Tax Revenue ,2011,Committed,1613120,3551224,T- 45
1945,Stockyards Southeast Quadrant,South Side,2012-03-09,Administrative Costs ,2011,Committed,-36574,3514650,T- 45
1946,Stockyards Southeast Quadrant,South Side,2012-03-09,Bond Debt Service - 2011 ,2011,Committed,-609325,2905325,T- 45
1947,Stony Island/Burnside,South Side,2021-06-10,FY Beginning Cash Balance ,2009,Appropriated,5429419,5429419,T- 54
1948,Stony Island/Burnside,South Side,2021-06-10,WVON 2009 RDA Payment ,2009,Appropriated,-250000,5179419,T- 54
1949,Stony Island/Burnside,South Side,2021-06-10,"Greenwood Associates, L.L.C. Note Payment ",2009,Appropriated,-322000,4857419,T- 54
1950,Stony Island/Burnside,South Side,2021-06-10,Trees @ 97th & University median ,2009,Committed,-800,4856619,T- 54
1951,Stony Island/Burnside,South Side,2021-06-10,New sidewalks: west side only of 8800 block of S. Jeffery Blvd. ,2009,Committed,-59192,4797427,T- 54
1952,Stony Island/Burnside,South Side,2021-06-10,SBIF Note Debt Service ,2009,Committed,-207375,4590052,T- 54
1953,Stony Island/Burnside,South Side,2021-06-10,Jessie Owens Park fieldhouse - TIF share ,2009,Committed,-1650000,2940052,T- 54
1954,Stony Island/Burnside,South Side,2021-06-10,"WPA reconstruction: Drexel, 90th to 91st. ",2009,Pending,-45000,2895052,T- 54
1955,Stony Island/Burnside,South Side,2021-06-10,WPA reconstruction: 94th-Woodlawn to Kenwood; design ,2009,Pending,-67500,2827552,T- 54
1956,Stony Island/Burnside,South Side,2021-06-10,Estimated Incremental Property Tax Revenue ,2010,Committed,2171944,4999496,T- 54
1957,Stony Island/Burnside,South Side,2021-06-10,Administrative Costs ,2010,Committed,-41400,4958096,T- 54
1958,Stony Island/Burnside,South Side,2021-06-10,CPD Improvements; Jessie Owens Park Lighting ,2010,Committed,-100000,4858096,T- 54
1959,Stony Island/Burnside,South Side,2021-06-10,SBIF Note Debt Service ,2010,Committed,-191188,4666908,T- 54
1960,Stony Island/Burnside,South Side,2021-06-10,WVON 2010 RDA Payment ,2010,Committed,-250000,4416908,T- 54
1961,Stony Island/Burnside,South Side,2021-06-10,MSAC Ph.1 Debt Service 2010 - port to 71st/Stony Island - S. Shore HS ,2010,Committed,-725660,3691248,T- 54
1962,Stony Island/Burnside,South Side,2021-06-10,Estimated Incremental Property Tax Revenue ,2011,Committed,2171944,5863192,T- 54
1963,Stony Island/Burnside,South Side,2021-06-10,Administrative Costs ,2011,Committed,-41400,5821792,T- 54
1964,Stony Island/Burnside,South Side,2021-06-10,"Greenwood Associates, L.L.C. Note Payment ",2011,Committed,-350000,5471792,T- 54
1965,Stony Island/Burnside,South Side,2021-06-10,MSAC Ph.1 Debt Service 2011 - port to 71st/Stony Island - S. Shore HS ,2011,Committed,-1101912,4369881,T- 54
1966,Stony Island/Burnside,South Side,2021-06-10,Potential Redevelopment Project ,2011,Pending,-1500000,2869881,T- 54
1967,Touhy and Western,North Side,2030-12-31,FY Beginning Cash Balance ,2009,Appropriated,568615,568615,T-146
1968,Touhy and Western,North Side,2030-12-31,"SBIF (1M auth., 750K remaining) ",2009,Appropriated,-250000,318615,T-146
1969,Touhy and Western,North Side,2030-12-31,Estimated Incremental Property Tax Revenue ,2010,Committed,593983,912598,T-146
1970,Touhy and Western,North Side,2030-12-31,Administrative Costs ,2010,Committed,0,912598,T-146
1971,Touhy and Western,North Side,2030-12-31,MSAC Ph.1 Debt Service 2010 - Touhy/Western share - Boone Clinton ,2010,Committed,-33823,878775,T-146
1972,Touhy and Western,North Side,2030-12-31,Estimated Incremental Property Tax Revenue ,2011,Committed,593983,1472758,T-146
1973,Touhy and Western,North Side,2030-12-31,Administrative Costs ,2011,Committed,0,1472758,T-146
1974,Touhy and Western,North Side,2030-12-31,MSAC Ph.1 Debt Service 2011 - Touhy/Western share - Boone Clinton ,2011,Committed,-67331,1405427,T-146
1975,Weed/Freemont,Northwest Side,2032-12-31,FY Beginning Cash Balance ,2009,Appropriated,0,0,T-158
1976,Weed/Freemont,Northwest Side,2032-12-31,Administration ,2009,Committed,0,0,T-158
1977,Weed/Freemont,Northwest Side,2032-12-31,Estimated Incremental Property Tax Revenue ,2010,Committed,0,0,T-158
1978,Weed/Freemont,Northwest Side,2032-12-31,Estimated Incremental Property Tax Revenue ,2011,Committed,0,0,T-158
1979,Western/Ogden Ind. Corridor,South Side,2030-12-31,FY Beginning Cash Balance ,2009,Appropriated,87325,87325,T- 48
1980,Western/Ogden Ind. Corridor,South Side,2030-12-31,PetsMart Note Payment ,2009,Appropriated,-41287,46038,T- 48
1981,Western/Ogden Ind. Corridor,South Side,2030-12-31,Estimated Incremental Property Tax Revenue ,2010,Committed,85223,131262,T- 48
1982,Western/Ogden Ind. Corridor,South Side,2030-12-31,Administrative Costs ,2010,Committed,-5735,125527,T- 48
1983,Western/Ogden Ind. Corridor,South Side,2030-12-31,Estimated Incremental Property Tax Revenue ,2011,Committed,85223,210750,T- 48
1984,Western/Ogden Ind. Corridor,South Side,2030-12-31,Administrative Costs ,2011,Committed,-5735,205015,T- 48
1985,Western/Ogden Ind. Corridor,South Side,2030-12-31,FY Beginning Cash Balance ,2009,Appropriated,2069681,2069681,T- 48
1986,Western/Ogden Ind. Corridor,South Side,2030-12-31,SBIF ,2009,Committed,-750000,1319681,T- 48
1987,Western/Ogden Ind. Corridor,South Side,2030-12-31,Estimated Incremental Property Tax Revenue ,2010,Committed,1087767,2407448,T- 48
1988,Western/Ogden Ind. Corridor,South Side,2030-12-31,Administrative Costs ,2010,Committed,-19400,2388048,T- 48
1989,Western/Ogden Ind. Corridor,South Side,2030-12-31,Estimated Incremental Property Tax Revenue ,2011,Committed,1087767,3475815,T- 48
1990,Western/Ogden Ind. Corridor,South Side,2030-12-31,Administrative Costs ,2011,Committed,-19400,3456415,T- 48
1991,Western/Ogden Ind. Corridor,South Side,2030-12-31,FY Beginning Cash Balance ,2009,Appropriated,112873,112873,T- 48
1992,Western/Ogden Ind. Corridor,South Side,2030-12-31,"Lighting: 119th, Ada - Peoria - Morgan - Loomis ",2009,Committed,-40500,72373,T- 48
1993,Western/Ogden Ind. Corridor,South Side,2030-12-31,"Street Reconstruction: Loomis, 120th-122nd ",2009,Pending,0,72373,T- 48
1994,Western/Ogden Ind. Corridor,South Side,2030-12-31,Estimated Incremental Property Tax Revenue ,2010,Committed,60000,132373,T- 48
1995,Western/Ogden Ind. Corridor,South Side,2030-12-31,Administrative Costs ,2010,Committed,-300,132073,T- 48
1996,Western/Ogden Ind. Corridor,South Side,2030-12-31,Estimated Incremental Property Tax Revenue ,2011,Committed,60000,192073,T- 48
1997,Western/Ogden Ind. Corridor,South Side,2030-12-31,Administrative Costs ,2011,Committed,-300,191773,T- 48
1998,Western/Ogden Ind. Corridor,South Side,2030-12-31,FY Beginning Cash Balance ,2009,Appropriated,1451958,1451958,T- 48
1999,Western/Ogden Ind. Corridor,South Side,2030-12-31,Target Note Payment - Feb 2009 ,2009,Appropriated,-781537,670420,T- 48
2000,Western/Ogden Ind. Corridor,South Side,2030-12-31,"Est. Property Tax Collections  -- 2008 levy, received 2009 ",2009,Committed,522195,1192615,T- 48
2001,Western/Ogden Ind. Corridor,South Side,2030-12-31,"Sidewalk: Peterson, Western to Raveswood  -- add'l ",2009,Committed,-11275,1181340,T- 48
2002,Western/Ogden Ind. Corridor,South Side,2030-12-31,Professional Services ,2009,Pending,-50000,1131340,T- 48
2003,Western/Ogden Ind. Corridor,South Side,2030-12-31,Residential lighting: various locations ,2009,Proposed,-290000,841340,T- 48
2004,Western/Ogden Ind. Corridor,South Side,2030-12-31,"Est. Property Tax Collections  -- 2009 levy, received 2010 ",2010,Committed,522195,1363535,T- 48
2005,Western/Ogden Ind. Corridor,South Side,2030-12-31,Administrative Costs ,2010,Committed,-12150,1351385,T- 48
2006,Western/Ogden Ind. Corridor,South Side,2030-12-31,Target Note Payment - Feb 2010 ,2010,Committed,-495106,856279,T- 48
2007,Western Avenue/Rock Island,West Side,2021-02-05,FY Beginning Cash Balance ,2009,Appropriated,11177156,11177156,T-142
2008,Western Avenue/Rock Island,West Side,2021-02-05,TIF Works ,2009,Appropriated,-200000,10977156,T-142
2009,Western Avenue/Rock Island,West Side,2021-02-05,CCIL Note -- s 2009 Payment ,2009,Appropriated,-756259,10220898,T-142
2010,Western Avenue/Rock Island,West Side,2021-02-05,Orozco Community Academy ,2009,Committed,-250000,9970898,T-142
2011,Western Avenue/Rock Island,West Side,2021-02-05,SBIF (1M auth.; remaining authority = 500k) ,2009,Committed,-500000,9470898,T-142
2012,Western Avenue/Rock Island,West Side,2021-02-05,Viaduct clearance ,2009,Committed,-611200,8859698,T-142
2013,Western Avenue/Rock Island,West Side,2021-02-05,Renovation of 2350 W. Ogden  -- DGS ,2009,Committed,-1000000,7859698,T-142
2014,Western Avenue/Rock Island,West Side,2021-02-05,Acquisition budget increase ,2009,Committed,-1500000,6359698,T-142
2015,Western Avenue/Rock Island,West Side,2021-02-05,Broadband Initiative ,2009,Pending,-264128,6095570,T-142
2016,Western Avenue/Rock Island,West Side,2021-02-05,Estimated Incremental Property Tax Revenue ,2010,Committed,7158000,13253570,T-142
2017,Western Avenue/Rock Island,West Side,2021-02-05,Administrative Costs ,2010,Committed,-81000,13172570,T-142
2018,Western Avenue/Rock Island,West Side,2021-02-05,"SBIF (1M auth., remaining auth. = 0) ",2010,Committed,-500000,12672570,T-142
2019,Western Avenue/Rock Island,West Side,2021-02-05,CCIL Note -- s 2010 Payment ,2010,Committed,-760000,11912570,T-142
2020,Western Avenue/Rock Island,West Side,2021-02-05,Acquisition budget increase ,2010,Committed,-1500000,10412570,T-142
2021,Western Avenue/Rock Island,West Side,2021-02-05,Potential Redevelopment Project ,2010,On Hold,-3000000,7412570,T-142
2022,Western Avenue/Rock Island,West Side,2021-02-05,Potential Redevelopment Project ,2010,Pending,-1000000,6412570,T-142
2023,Western Avenue/Rock Island,West Side,2021-02-05,Estimated Incremental Property Tax Revenue ,2011,Committed,7158000,13570570,T-142
2024,Western Avenue/Rock Island,West Side,2021-02-05,Administrative Costs ,2011,Committed,-81000,13489570,T-142
2025,Western Avenue/Rock Island,West Side,2021-02-05,CCIL Note -- s 2011 Payment ,2011,Committed,-760000,12729570,T-142
2026,Western Avenue/Rock Island,West Side,2021-02-05,Acquisition budget increase ,2011,Committed,-1500000,11229570,T-142
2027,Western Avenue/Rock Island,West Side,2021-02-05,Potential Redevelopment Project ,2011,Pending,-1000000,10229570,T-142
2028,Western/Ogden Ind. Corridor,South Side,2030-12-31,FY Beginning Cash Balance ,2009,Appropriated,1586061,1586061,T- 48
2029,Western/Ogden Ind. Corridor,South Side,2030-12-31,Rebuild bus pad @ 2401 W. 103rd ,2009,Appropriated,-36000,1550061,T- 48
2030,Western/Ogden Ind. Corridor,South Side,2030-12-31,SBIF ,2009,Committed,-200000,1350061,T- 48
2031,Western/Ogden Ind. Corridor,South Side,2030-12-31,Streetscape master plan: 96th to 119th ,2009,Committed,-365000,985061,T- 48
2032,Western/Ogden Ind. Corridor,South Side,2030-12-31,Broadband Initiative ,2009,Pending,-41950,943111,T- 48
2033,Western/Ogden Ind. Corridor,South Side,2030-12-31,Estimated Incremental Property Tax Revenue ,2010,Committed,1500000,2443111,T- 48
2034,Western/Ogden Ind. Corridor,South Side,2030-12-31,Program Administraiton ,2010,Committed,-4500,2438611,T- 48
2035,Western/Ogden Ind. Corridor,South Side,2030-12-31,Port to 119th/I-57 for Blackwelder Park ,2010,Committed,-1250000,1188611,T- 48
2036,Western/Ogden Ind. Corridor,South Side,2030-12-31,Estimated Incremental Property Tax Revenue ,2011,Committed,1500000,2688611,T- 48
2037,Western/Ogden Ind. Corridor,South Side,2030-12-31,Program Administraiton ,2011,Committed,-4500,2684111,T- 48
2038,Western/Ogden Ind. Corridor,South Side,2030-12-31,FY Beginning Cash Balance ,2009,Appropriated,9516294,9516294,T- 48
2039,Western/Ogden Ind. Corridor,South Side,2030-12-31,4800 Damen LLC ,2009,Appropriated,-409463,9106831,T- 48
2040,Western/Ogden Ind. Corridor,South Side,2030-12-31,Port to Clark/Montrose re: Clark Streetscape ,2009,Appropriated,-2000000,7106831,T- 48
2041,Western/Ogden Ind. Corridor,South Side,2030-12-31,Pre-Acquisition Account ,2009,Committed,-50000,7056831,T- 48
2042,Western/Ogden Ind. Corridor,South Side,2030-12-31,Berlin Wall Monument Installation ,2009,Committed,-240000,6816831,T- 48
2043,Western/Ogden Ind. Corridor,South Side,2030-12-31,SBIF ,2009,Committed,-1000000,5816831,T- 48
2044,Western/Ogden Ind. Corridor,South Side,2030-12-31,Port to Western Ave. South for Lane Tech Reimbursement ,2009,Committed,-1892100,3924731,T- 48
2045,Western/Ogden Ind. Corridor,South Side,2030-12-31,Estimated Incremental Property Tax Revenue ,2010,Committed,3540375,7465105,T- 48
2046,Western/Ogden Ind. Corridor,South Side,2030-12-31,Administrative Costs ,2010,Committed,-63000,7402105,T- 48
2047,Western/Ogden Ind. Corridor,South Side,2030-12-31,MSAC Ph.1 Debt Service 2010 - port to Lincoln Ave. - Mather HS ,2010,Committed,-1205798,6196308,T- 48
2048,Western/Ogden Ind. Corridor,South Side,2030-12-31,Estimated Incremental Property Tax Revenue ,2011,Committed,3540375,9736682,T- 48
2049,Western/Ogden Ind. Corridor,South Side,2030-12-31,Administrative Costs ,2011,Committed,-63000,9673682,T- 48
2050,Western/Ogden Ind. Corridor,South Side,2030-12-31,MSAC Ph.1 Debt Service 2011 - port to Lincoln Ave. - Mather HS ,2011,Committed,-1363785,8309898,T- 48
2051,Western/Ogden Ind. Corridor,South Side,2030-12-31,FY Beginning Cash Balance ,2009,Appropriated,11285394,11285394,T- 48
2052,Western/Ogden Ind. Corridor,South Side,2030-12-31,Safe Routes to School match @ Lane Tech ,2009,Appropriated,-40000,11245394,T- 48
2053,Western/Ogden Ind. Corridor,South Side,2030-12-31,Pre- Acquisition ,2009,Appropriated,-50000,11195394,T- 48
2054,Western/Ogden Ind. Corridor,South Side,2030-12-31,North Center Senior Housing  -- TACH payment ,2009,Appropriated,-66695,11128698,T- 48
2055,Western/Ogden Ind. Corridor,South Side,2030-12-31,"Streetscape: Irving Pk, River to Ravenswood  -- constr. Phase 1 ",2009,Appropriated,-6000000,5128698,T- 48
2056,Western/Ogden Ind. Corridor,South Side,2030-12-31,Port from Western Ave. North for Lane Tech Reimbursement ,2009,Committed,1892100,7020798,T- 48
2057,Western/Ogden Ind. Corridor,South Side,2030-12-31,Traffic signal @ Campbell & Addison ,2009,Committed,-350000,6670798,T- 48
2058,Western/Ogden Ind. Corridor,South Side,2030-12-31,Lane Tech Reimbursement ,2009,Committed,-1892100,4778698,T- 48
2059,Western/Ogden Ind. Corridor,South Side,2030-12-31,Coonley School Renovations ,2009,Committed,-2201500,2577198,T- 48
2060,Western/Ogden Ind. Corridor,South Side,2030-12-31,Belle Plaine Commons ,2009,Committed,-3400000,-822802,T- 48
2061,Western/Ogden Ind. Corridor,South Side,2030-12-31,Addision Industrial Corridor Study ,2009,Pending,-50000,-872802,T- 48
2062,Western/Ogden Ind. Corridor,South Side,2030-12-31,Boys & Girls Club Fieldhouse improvements  -- 2501 W. Irving Pk Rd ,2009,Proposed,-200000,-1072802,T- 48
2063,Western/Ogden Ind. Corridor,South Side,2030-12-31,Estimated Incremental Property Tax Revenue ,2010,Committed,4771391,3698589,T- 48
2064,Western/Ogden Ind. Corridor,South Side,2030-12-31,Administrative Costs ,2010,Committed,-90300,3608289,T- 48
2065,Western/Ogden Ind. Corridor,South Side,2030-12-31,North Center Senior Housing  -- TACH payment ,2010,Committed,-100000,3508289,T- 48
2066,Western/Ogden Ind. Corridor,South Side,2030-12-31,Estimated Incremental Property Tax Revenue ,2011,Committed,4771391,8279680,T- 48
2067,Western/Ogden Ind. Corridor,South Side,2030-12-31,Administrative Costs ,2011,Committed,-90300,8189380,T- 48
2068,Wilson Yard,North Side,2025-12-31,FY Beginning Cash Balance ,2009,Appropriated,11447451,11447451,T-110
2069,Wilson Yard,North Side,2025-12-31,Pre-acquisition Account Increase ,2009,Appropriated,-50000,11397451,T-110
2070,Wilson Yard,North Side,2025-12-31,Professional services account increase ,2009,Appropriated,-62208,11335243,T-110
2071,Wilson Yard,North Side,2025-12-31,Truman College IGA Annual Payment ,2009,Committed,-1135660,10199583,T-110
2072,Wilson Yard,North Side,2025-12-31,Annual Debt Service Payment Wilson Yard Notes-March 2009 ,2009,Committed,-3327457,6872126,T-110
2073,Wilson Yard,North Side,2025-12-31,"Broadway Streetscape, widening of Broadway  -- Montrose to Wilson Construction ",2009,Committed,-3750000,3122126,T-110
2074,Wilson Yard,North Side,2025-12-31,Estimated Incremental Property Tax Revenue ,2010,Committed,5164319,8286445,T-110
2075,Wilson Yard,North Side,2025-12-31,Administrative Costs ,2010,Committed,-96500,8189945,T-110
2076,Wilson Yard,North Side,2025-12-31,Truman College IGA Annual Payment ,2010,Committed,-1135660,7054286,T-110
2077,Wilson Yard,North Side,2025-12-31,Arai School Facility Improvements and Parking Lot ,2010,Committed,-1491173,5563113,T-110
2078,Wilson Yard,North Side,2025-12-31,Annual Debt Service Payment Wilson Yard Notes - March 2010 ,2010,Committed,-3572867,1990246,T-110
2079,Wilson Yard,North Side,2025-12-31,Clifton/Magnolia Apts. Annual Payment ,2010,Pending,-375000,1615246,T-110
2080,Wilson Yard,North Side,2025-12-31,CTA Wilson stop improvements ,2010,Proposed,-3000000,-1384754,T-110
2081,Wilson Yard,North Side,2025-12-31,Estimated Incremental Property Tax Revenue ,2011,Committed,5164319,3779565,T-110
2082,Wilson Yard,North Side,2025-12-31,Administrative Costs ,2011,Committed,-96500,3683065,T-110
2083,Wilson Yard,North Side,2025-12-31,Truman College IGA Annual Payment ,2011,Committed,-1135660,2547406,T-110
2084,Wilson Yard,North Side,2025-12-31,Annual Debt Service Payment Wilson Yard Notes - March 2011 ,2011,Committed,-3572867,-1025462,T-110
2085,Wilson Yard,North Side,2025-12-31,Clifton/Magnolia Apts. Annual Payment ,2011,Pending,-375000,-1400462,T-110
2086,Woodlawn,South Side,2022-06-20,FY Beginning Cash Balance ,2009,Appropriated,7037659,7037659,T- 65
2087,Woodlawn,South Side,2022-06-20,DOB demolition reimbursement  -- 6325 S. Woodlawn ,2009,Appropriated,-4100,7033559,T- 65
2088,Woodlawn,South Side,2022-06-20,DOB demolition reimbursement  -- 6329 S Woodlawn ,2009,Appropriated,-4120,7029439,T- 65
2089,Woodlawn,South Side,2022-06-20,DOB demolition reimbursement  -- 6331 S. Woodlawn ,2009,Appropriated,-4750,7024689,T- 65
2090,Woodlawn,South Side,2022-06-20,DOB demolition reimbursement  -- 6311 S. Woodlawn ,2009,Appropriated,-5060,7019629,T- 65
2091,Woodlawn,South Side,2022-06-20,DOB demolition reimbursement  -- 927 E. 63rd Street ,2009,Appropriated,-8800,7010829,T- 65
2092,Woodlawn,South Side,2022-06-20,DOB demolition reimbursement  -- 1321 E. 63rd Street ,2009,Appropriated,-9400,7001429,T- 65
2093,Woodlawn,South Side,2022-06-20,DOB demolition reimbursement  -- 1154 E. 63rd Street ,2009,Appropriated,-9600,6991829,T- 65
2094,Woodlawn,South Side,2022-06-20,DOB demolition reimbursement  -- 910-26 E. 63rd Street ,2009,Appropriated,-21900,6969929,T- 65
2095,Woodlawn,South Side,2022-06-20,DOB demolition reimbursement  -- 1127 E. 63rd Street ,2009,Appropriated,-33000,6936929,T- 65
2096,Woodlawn,South Side,2022-06-20,DOB demolition reimbursement  -- 1300-28 E. 63rd Street ,2009,Appropriated,-138600,6798329,T- 65
2097,Woodlawn,South Side,2022-06-20,Columbia Pointe RDA (TBD) ,2009,Committed,0,6798329,T- 65
2098,Woodlawn,South Side,2022-06-20,"Street resurfacing: 62nd St, Dorchester to Blackstone ",2009,Committed,-19616,6778713,T- 65
2099,Woodlawn,South Side,2022-06-20,"Sidewalks: Marquette Rd, Maryland to Drexel ",2009,Committed,-20259,6758454,T- 65
2100,Woodlawn,South Side,2022-06-20,Pre-acquisition ,2009,Committed,-50000,6708454,T- 65
2101,Woodlawn,South Side,2022-06-20,"Sidewalks: 64th St, University to Woodlawn ",2009,Committed,-67231,6641223,T- 65
2102,Woodlawn,South Side,2022-06-20,"Street resurfacing: Woodlawn, 63rd St to 65th St ",2009,Committed,-93385,6547838,T- 65
2103,Woodlawn,South Side,2022-06-20,"Sidewalks: 64th St, Greenwood to University ",2009,Committed,-107212,6440626,T- 65
2104,Woodlawn,South Side,2022-06-20,Sidewalks: Greenwood 63rd to 64th ,2009,Committed,-147760,6292866,T- 65
2105,Woodlawn,South Side,2022-06-20,CPS ADA projects  -- Fiske ,2009,Committed,-1500000,4792866,T- 65
2106,Woodlawn,South Side,2022-06-20,SBIF / NIF ,2009,Pending,-1000000,3792866,T- 65
2107,Woodlawn,South Side,2022-06-20,Estimated Incremental Property Tax Revenue ,2010,Committed,2369243,6162109,T- 65
2108,Woodlawn,South Side,2022-06-20,Administrative Costs ,2010,Committed,-45100,6117009,T- 65
2109,Woodlawn,South Side,2022-06-20,MSAC Ph.1 Debt Service 2010 - port to 71st/Stony Island - S. Shore HS ,2010,Committed,-1013463,5103546,T- 65
2110,Woodlawn,South Side,2022-06-20,Estimated Incremental Property Tax Revenue ,2011,Committed,2369243,7472789,T- 65
2111,Woodlawn,South Side,2022-06-20,Administrative Costs ,2011,Committed,-45100,7427689,T- 65
2112,Woodlawn,South Side,2022-06-20,MSAC Ph.1 Debt Service 2011 - port to 71st/Stony Island - S. Shore HS ,2011,Committed,-1147501,6280189,T- 65
